Ticker	Company
A	Agilent Technologies Inc.
AA	Alcoa Inc.
AADR	AdvisorShares WCMBNY Mln Fcsd GR ADR ETF
AAIT	iShares MSCI AC Asia Information Tech
AAL	American Airlines Group Inc.
AAMC	Altisource Asset Management Corporation
AAME	Atlantic American Corp.
AAN	Aaron's
AAOI	Applied Optoelectronics
AAON	AAON Inc.
AAP	Advance Auto Parts Inc.
AAPL	Apple Inc.
AAT	American Assets Trust
AAU	Almaden Minerals Ltd.
AAV	Advantage Oil & Gas Ltd.
AAWW	Atlas Air Worldwide Holdings Inc.
AAXJ	iShares MSCI All Country Asia ex Jpn Idx
AB	AllianceBernstein Holding L.P.
ABAX	Abaxis
ABB	ABB Ltd.
ABBV	AbbVie Inc.
ABC	AmerisourceBergen Corporation
ABCB	Ameris Bancorp
ABCD	Cambium Learning Group
ABCO	The Advisory Board Company
ABG	Asbury Automotive Group
ABIO	ARCA biopharma
ABM	ABM Industries Incorporated
ABMD	ABIOMED
ABR	Arbor Realty Trust Inc.
ABT	Abbott Laboratories
ABTL	Autobytel Inc.
ABX	Barrick Gold Corporation
ABY	Abengoa Yield plc
ACAD	ACADIA Pharmaceuticals Inc.
ACAS	American Capital
ACAT	Arctic Cat Inc.
ACC	American Campus Communities
ACCO	ACCO Brands Corporation
ACCU	AdvisorShares Accuvest Global Opport ETF
ACE	ACE Limited
ACET	Aceto Corp.
ACFC	Atlantic Coast Financial Corporation
ACFN	Acorn Energy
ACG	AllianceBernstein Income Fund
ACGL	Arch Capital Group Ltd.
ACH	Aluminum Corporation Of China Limited
ACHC	Acadia Healthcare Company
ACHN	Achillion Pharmaceuticals
ACI	Arch Coal Inc.
ACIM	SPDR MSCI ACWI IMI
ACIW	ACI Worldwide
ACLS	Axcelis Technologies Inc.
ACM	AECOM Technology Corporation
ACMP	Access Midstream Partners
ACN	Accenture plc
ACNB	ACNB Corp.
ACOR	Acorda Therapeutics
ACPW	Active Power Inc.
ACRE	Ares Commercial Real Estate Corporation
ACRX	AcelRx Pharmaceuticals
ACST	Acasti Pharma Inc.
ACT	Actavis plc
ACTG	Acacia Research Corporation
ACTS	Actions Semiconductor Co.
ACU	Acme United Corp.
ACUR	Acura Pharmaceuticals
ACW	Accuride Corp.
ACWI	iShares MSCI ACWI Index
ACWX	iShares MSCI ACWI ex US Index
ACXM	Acxiom Corporation
ACY	AeroCentury Corp.
ADAT	Authentidate Holding Corp.
ADBE	Adobe Systems Inc.
ADC	Agree Realty Corp.
ADEP	Adept Technology Inc.
ADES	Advanced Emissions Solutions
ADGE	American DG Energy
ADHD	Alcobra Ltd.
ADI	Analog Devices
ADK	AdCare Health Systems Inc.
ADM	Archer Daniels Midland Company
ADMP	Adamis Pharmaceuticals Corporation
ADMS	Adamas Pharmaceuticals
ADNC	Audience
ADP	Automatic Data Processing
ADRA	BLDRS Asia 50 ADR ETF
ADRD	BLDRS Developed Markets 100 ADR ETF
ADRE	BLDRS Emerging Markets 50 ADR ETF
ADRU	BLDRS Europe Select ADR ETF
ADS	Alliance Data Systems Corporation
ADSK	Autodesk
ADT	The ADT Corporation
ADTN	ADTRAN Inc.
ADUS	Addus HomeCare Corporation
ADVS	Advent Software
ADX	The Adams Express Company
ADXS	Advaxis
ADZ	PowerShares DB Agriculture Short ETN
AE	Adams Resources & Energy Inc.
AEC	Associated Estates Realty Corporation
AEE	Ameren Corporation
AEG	AEGON N.V.
AEGN	Aegion Corporation
AEGR	Aegerion Pharmaceuticals
AEHR	Aehr Test Systems
AEIS	Advanced Energy Industries
AEL	American Equity Investment Life Holding Co.
AEM	Agnico Eagle Mines Limited
AEO	American Eagle Outfitters
AEP	American Electric Power Co.
AEPI	AEP Industries Inc.
AER	AerCap Holdings N.V.
AERI	Aerie Pharmaceuticals
AES	The AES Corporation
AET	Aetna Inc.
AETI	American Electric Technologies
AEY	ADDvantage Technologies Group Inc.
AEZS	Aeterna Zentaris Inc.
AF	Astoria Financial Corporation
AFAM	Almost Family Inc.
AFB	AllianceBernstein National Municipal Income Fund
AFCB	Athens Bancshares Corporation
AFFX	Affymetrix Inc.
AFG	American Financial Group Inc.
AFH	Atlas Financial Holdings
AFK	Market Vectors Africa ETF
AFL	AFLAC Inc.
AFOP	Alliance Fiber Optic Products Inc.
AFSI	AmTrust Financial Services
AG	First Majestic Silver Corp.
AGA	PowerShares DB Agriculture Dble Shrt ETN
AGCO	AGCO Corporation
AGD	Alpine Global Dynamic Dividend Fund
AGEN	Agenus Inc.
AGF	PowerShares DB Agriculture Long ETN
AGG	iShares Core US Aggregate Bond
AGI	Alamos Gold Inc.
AGII	Argo Group International Holdings
AGIO	Agios Pharmaceuticals
AGLS	AdvisorShares Accuvest Glbl Lg Sht ETF
AGM	Federal Agricultural Mortgage Corp.
AGN	Allergan Inc.
AGNC	American Capital Agency Corp.
AGO	Assured Guaranty Ltd.
AGQ	ProShares Ultra Silver
AGRO	Adecoagro S.A.
AGRX	Agile Therapeutics
AGTC	Applied Genetic Technologies Corporation
AGU	Agrium Inc.
AGX	Argan
AGYS	Agilysys Inc.
AGZ	iShares Agency Bond
AHC	A. H. Belo Corporation
AHGP	Alliance Holdings GP
AHH	Armada Hoffler Properties
AHL	Aspen Insurance Holdings Ltd.
AHP	Ashford Hospitality Prime
AHPI	Allied Healthcare Products Inc.
AHS	AMN Healthcare Services Inc.
AHT	Ashford Hospitality Trust
AI	Arlington Asset Investment Corp.
AIA	iShares Asia 50
AIG	American International Group
AIMC	Altra Industrial Motion Corp.
AIN	Albany International Corp.
AINV	Apollo Investment Corporation
AIQ	Alliance Healthcare Services
AIR	AAR Corp.
AIRI	Air Industries Group
AIRM	Air Methods Corp.
AIRR	First Trust RBA American Indl Rnsnc
AIRT	Air T Inc.
AIT	Applied Industrial Technologies
AIV	Apartment Investment and Management Company
AIXG	Aixtron SE
AIZ	Assurant Inc.
AJG	Arthur J Gallagher & Co.
AKAM	Akamai Technologies
AKAO	Achaogen
AKBA	Akebia Therapeutics
AKG	Asanko Gold Inc.
AKO-A	Embotelladora Andina S.A.
AKO-B	Embotelladora Andina S.A.
AKP	Alliance California Municipal I
AKR	Acadia Realty Trust
AKRX	Akorn
AKS	AK Steel Holding Corporation
AL	Air Lease Corporation
ALB	Albemarle Corporation
ALCO	Alico Inc.
ALCS	ALCO Stores
ALD	WisdomTree Asia Local Debt
ALDR	Alder Biopharmaceuticals Inc.
ALDW	Alon USA Partners
ALDX	Aldeyra Therapeutics
ALE	ALLETE
ALEX	Alexander & Baldwin
ALFA	AlphaClone Alternative Alpha ETF
ALG	Alamo Group
ALGN	Align Technology Inc.
ALGT	Allegiant Travel Company
ALIM	Alimera Sciences
ALJ	Alon USA Energy
ALK	Alaska Air Group
ALKS	Alkermes plc
ALL	The Allstate Corporation
ALLB	Alliance Bancorp Inc of Pennsylvania
ALLE	Allegion plc
ALLT	Allot Communications Ltd.
ALLY	Ally Financial Inc.
ALN	American Lorain Corporation
ALNY	Alnylam Pharmaceuticals
ALOG	Analogic Corporation
ALOT	Astro-Med
ALQA	Alliqua
ALR	Alere Inc.
ALSK	Alaska Communications Systems Group Inc.
ALSN	Allison Transmission Holdings
ALTI	Altair Nanotechnologies
ALTR	Altera Corp.
ALTV	Alteva
ALU	Alcatel-Lucent
ALV	Autoliv
ALX	Alexander's Inc.
ALXA	Alexza Pharmaceuticals Inc.
ALXN	Alexion Pharmaceuticals
AMAG	AMAG Pharmaceuticals
AMAP	AutoNavi Holdings Limited
AMAT	Applied Materials
AMBA	Ambarella
AMBC	Ambac Financial Group
AMBI	Ambit Biosciences Corporation
AMBR	Amber Road
AMC	AMC Entertainment Holdings
AMCC	Applied Micro Circuits Corporation
AMCF	Andatee China Marine Fuel Services Corporation
AMCN	AirMedia Group Inc.
AMCO	Armco Metals Holdings
AMCX	AMC Networks Inc.
AMD	Advanced Micro Devices
AMDA	Amedica Corporation
AME	Ametek Inc.
AMED	Amedisys Inc.
AMG	Affiliated Managers Group Inc.
AMGN	Amgen Inc.
AMH	American Homes 4 Rent
AMIC	American Independence Corp.
AMID	American Midstream Partners
AMJ	JPMorgan Alerian MLP ETN
AMKR	Amkor Technology
AMLP	ALPS Alerian MLP ETF
AMNB	American National Bankshares Inc.
AMOT	Allied Motion Technologies Inc.
AMP	Ameriprise Financial
AMPE	Ampio Pharmaceuticals
AMPH	Amphastar Pharmaceuticals
AMPS	iShares Utilities Bond
AMRB	American River Bankshares
AMRC	Ameresco
AMRE	AmREIT
AMRI	Albany Molecular Research Inc.
AMRK	A-Mark Precious Metals
AMRN	Amarin Corporation plc
AMRS	Amyris
AMS	American Shared Hospital Services
AMSC	American Superconductor Corporation
AMSF	Amerisafe
AMSG	AmSurg Corp.
AMSWA	American Software
AMT	American Tower Corporation
AMTD	TD Ameritrade Holding Corporation
AMTG	Apollo Residential Mortgage
AMTX	Aemetis
AMU	UBS E-TRACS Alerian MLP Index ETN
AMWD	American Woodmark Corp.
AMX	America Movil S.A.B. de C.V.
AMZG	American Eagle Energy Corporation
AMZN	Amazon.com Inc.
AN	AutoNation Inc.
ANAC	Anacor Pharmaceuticals
ANAD	Anadigics
ANAT	American National Insurance Co.
ANCB	Anchor Bancorp
ANCI	American Caresource Holdings
ANCX	Access National Corporation
ANDE	The Andersons
ANET	Arista Networks
ANF	Abercrombie & Fitch Co.
ANGI	Angie's List
ANGL	Market Vectors FallenAngel HiYld Bd ETF
ANGO	AngioDynamics Inc.
ANH	Anworth Mortgage Asset Corporation
ANIK	Anika Therapeutics Inc.
ANIP	ANI Pharmaceuticals
ANN	ANN INC.
ANR	Alpha Natural Resources
ANSS	Ansys
ANTH	Anthera Pharmaceuticals
ANV	Allied Nevada Gold Corp.
ANW	Aegean Marine Petroleum Network Inc.
AOA	iShares Aggressive Allocation
AOD	Alpine Total Dynamic Dividend F
AOI	Alliance One International
AOK	iShares Conservative Allocation
AOL	AOL Inc.
AOM	iShares Moderate Allocation
AON	Aon plc
AOR	iShares Growth Allocation
AOS	AO Smith Corp.
AOSL	Alpha & Omega Semiconductor
AP	Ampco-Pittsburgh Corp.
APA	Apache Corp.
APAGF	Apco Oil & Gas International Inc.
APAM	Artisan Partners Asset Management Inc.
APB	Asia Pacific Fund Inc.
APC	Anadarko Petroleum Corporation
APD	Air Products & Chemicals Inc.
APEI	American Public Education
APF	Morgan Stanley Asia-Pacific Fund Inc.
APH	Amphenol Corporation
API	Advanced Photonix Inc.
APL	Atlas Pipeline Partners
APO	Apollo Global Management
APOG	Apogee Enterprises
APOL	Apollo Education Group
APP	American Apparel
APPY	Venaxis
APRI	Apricus Biosciences
APSA	Alto Palermo S.A.
APT	Alpha Pro Tech Ltd.
APTS	Preferred Apartment Communities
APU	AmeriGas Partners LP
APWC	Asia Pacific Wire & Cable Corp. Ltd.
AQU	Aquasition Corp.
AQXP	Aquinox Pharmaceuticals Inc.
AR	Antero Resources Corporation
ARAY	Accuray Incorporated
ARC	ARC Document Solutions
ARCB	ArcBest Corporation
ARCC	Ares Capital Corporation
ARCI	Appliance Recycling Centers of America Inc.
ARCO	Arcos Dorados Holdings Inc. Cla
ARCP	American Realty Capital Properties
ARCW	ARC Group Worldwide
ARCX	Arc Logistics Partners LP
ARDM	Aradigm Corporation
ARDX	Ardelyx
ARE	Alexandria Real Estate Equities
ARES	Ares Management
AREX	Approach Resources
ARG	Airgas
ARGT	Global X FTSE Argentina 20 ETF
ARI	Apollo Commercial Real Estate Finance
ARIA	Ariad Pharmaceuticals Inc.
ARII	American Railcar Industries
ARIS	ARI Network Services Inc.
ARKR	Ark Restaurants Corp.
ARL	American Realty Investors Inc.
ARLP	Alliance Resource Partners LP
ARMH	ARM Holdings plc
ARMK	Aramark
ARNA	Arena Pharmaceuticals
ARO	Aeropostale
AROW	Arrow Financial Corporation
ARP	Atlas Resource Partners
ARPI	American Residential Properties
ARQL	ArQule Inc.
ARR	ARMOUR Residential REIT
ARRS	ARRIS Group
ARRY	Array BioPharma
ARTNA	Artesian Resources Corp.
ARTW	Art's-Way Manufacturing Co. Inc.
ARTX	Arotech Corporation
ARUN	Aruba Networks
ARW	Arrow Electronics
ARWR	Arrowhead Research Corp.
ARX	Aeroflex Holding Corp.
ASA	ASA Gold and Precious Metals Limited
ASBB	ASB Bancorp
ASBC	Associated Banc-Corp
ASBI	Ameriana Bancorp
ASC	Ardmore Shipping Corporation
ASCMA	Ascent Capital Group
ASEA	Global X FTSE ASEAN 40 ETF
ASEI	American Science & Engineering Inc.
ASFI	Asta Funding Inc.
ASG	Liberty All Star Growth Fund Inc.
ASGN	On Assignment Inc.
ASH	Ashland Inc.
ASHR	Deutsche X-trackers Harvest CSI300 CHN A
ASHS	db X-trackers Hrvst CSI 500China A Sm Cp
ASM	Avino Silver & Gold Mines Ltd.
ASMI	ASM International NV
ASML	ASML Holding NV
ASNA	Ascena Retail Group Inc.
ASP	American Strategic Income Portfolio Inc.
ASPN	Aspen Aerogels
ASPS	Altisource Portfolio Solutions S.A.
ASPX	Auspex Pharmaceuticals
ASR	Grupo Aeroportuario del Sureste
ASRV	AmeriServ Financial
ASTC	Astrotech Corp.
ASTE	Astec Industries
ASTI	Ascent Solar Technologies
ASTM	Aastrom Biosciences
ASUR	Asure Software
ASX	Advanced Semiconductor Engineering Inc.
ASYS	Amtech Systems Inc.
AT	Atlantic Power Corporation
ATAI	ATA
ATAX	America First Multifamily Investors
ATE	Advantest Corporation
ATEA	Astea International Inc.
ATEC	Alphatec Holdings
ATEN	A10 Networks
ATHL	Athlon Energy Inc.
ATHM	Autohome Inc.
ATHN	athenahealth
ATHX	Athersys
ATI	Allegheny Technologies Inc.
ATK	Alliant Techsystems Inc.
ATL	Atlatsa Resources Corporation
ATLC	Atlanticus Holdings Corporation
ATLO	Ames National Corporation
ATLS	Atlas Energy
ATML	Atmel Corporation
ATNI	Atlantic Tele-Network
ATNM	Actinium Pharmaceuticals
ATNY	API Technologies Corp.
ATO	Atmos Energy Corporation
ATOS	Atossa Genetics
ATR	AptarGroup
ATRC	AtriCure
ATRI	ATRION Corp.
ATRM	Aetrium Inc.
ATRO	Astronics Corporation
ATRS	Antares Pharma Inc.
ATSG	Air Transport Services Group
ATTU	Attunity
ATU	Actuant Corporation
ATV	Acorn International
ATVI	Activision Blizzard
ATW	Atwood Oceanics
AU	AngloGold Ashanti Ltd.
AUBN	Auburn National Bancorporation
AUD	PIMCO Australia Bond ETF
AUDC	AudioCodes Ltd.
AUMN	Golden Minerals Company
AUNZ	WisdomTree Australia & New Zealand Debt
AUO	AU Optronics Corp.
AUQ	AuRico Gold Inc.
AUSE	WisdomTree Australia Dividend
AUXL	Auxilium Pharmaceuticals Inc.
AUY	Yamana Gold
AV	Aviva plc
AVA	Avista Corp.
AVAV	AeroVironment
AVB	Avalonbay Communities Inc.
AVD	American Vanguard Corp.
AVEO	AVEO Pharmaceuticals
AVG	AVG Technologies N.V.
AVGO	Avago Technologies Limited
AVHI	AV Homes
AVIV	Aviv REIT
AVK	Advent Claymore Convertible Securities and Income Fund
AVL	Avalon Rare Metals Inc.
AVNR	Avanir Pharmaceuticals
AVNW	Aviat Networks
AVP	Avon Products Inc.
AVT	Avnet
AVX	AVX Corp.
AVY	Avery Dennison Corporation
AWAY	HomeAway
AWF	AllianceBernstein Global High Income Fund
AWH	Allied World Assurance Company Holdings
AWI	Armstrong World Industries
AWK	American Water Works Company
AWP	Alpine Global Premier Propertie
AWR	American States Water Company
AWRE	Aware
AWX	Avalon Holdings Corp.
AXAS	Abraxas Petroleum Corp.
AXDX	Accelerate Diagnostics
AXE	Anixter International Inc.
AXGN	AxoGen
AXJL	WisdomTree Asia Pacific ex-Japan
AXJS	iShares MSCI AC Asia ex Japan Small Cap
AXJV	iShares MSCI Asia ex Japan Minimum Vol
AXL	American Axle & Manufacturing Holdings Inc.
AXLL	Axiall Corporation
AXN	Aoxing Pharmaceutical Company
AXP	American Express Company
AXR	AMREP Corporation
AXS	AXIS Capital Holdings Limited
AXTI	AXT Inc.
AXU	Alexco Resource Corporation
AXX	Alderon Iron Ore Corp.
AYI	Acuity Brands
AYN	Alliance New York Municipal Inc
AYR	Aircastle LTD
AYT	iPath GEMS Asia 8 ETN
AZC	Augusta Resource Corp.
AZIA	Global X Central Asia & Mongolia ETF
AZN	AstraZeneca PLC
AZO	AutoZone
AZPN	Aspen Technology
AZZ	AZZ incorporated
B	Barnes Group Inc.
BA	The Boeing Company
BAA	Banro Corporation
BAB	PowerShares Build America Bond ETF
BABS	SPDR Nuveen Barclays Build Amer Bd ETF
BABY	Natus Medical Inc.
BABZ	PIMCO Build America Bond ETF
BAC	Bank of America Corporation
BAF	BlackRock Insured Municipal Income Investment Trust
BAGL	Einstein Noah Restaurant Group
BAGR	Diversified Restaurant Holdings
BAH	Booz Allen Hamilton Holding Corporation
BAK	Braskem S.A.
BAL	iPath DJ-UBS Cotton TR Sub-Idx ETN
BALT	Baltic Trading Limited
BAM	Brookfield Asset Management Inc.
BAMM	Books-A-Million Inc.
BANC	Banc of California
BANF	BancFirst Corporation
BANR	Banner Corporation
BAP	Credicorp Ltd.
BAS	Basic Energy Services
BASI	Bioanalytical Systems Inc.
BAX	Baxter International Inc.
BAXS	Baxano Surgical
BBBY	Bed Bath & Beyond Inc.
BBCN	BBCN Bancorp
BBD	Banco Bradesco S.A.
BBDO	Banco Bradesco S.A.
BBEP	Breitburn Energy Partners L.P.
BBF	BlackRock Municipal Income Investment Trust
BBG	Bill Barrett Corp.
BBGI	Beasley Broadcast Group Inc.
BBH	Market Vectors Biotech ETF
BBK	BlackRock Municipal Bond Trust
BBL	BHP Billiton plc
BBNK	Bridge Capital Holdings
BBOX	Black Box Corporation
BBRC	EGShares Beyond BRICs ETF
BBRG	Bravo Brio Restaurant Group
BBRY	Research In Motion Limited
BBSI	Barrett Business Services Inc.
BBT	BB&T Corporation
BBVA	Banco Bilbao Vizcaya Argentaria
BBW	Build-A-Bear Workshop Inc.
BBX	BBX Capital Corporation
BBY	Best Buy Co.
BC	Brunswick Corporation
BCA	CorpBanca
BCBP	BCB Bancorp Inc.
BCC	Boise Cascade Company
BCE	BCE Inc.
BCEI	Bonanza Creek Energy
BCF	Blackrock Real Asset Equity Tru
BCH	Banco de Chile
BCM	iPath Pure Beta Broad Commodity ETN
BCO	The Brink's Company
BCOM	B Communications Ltd
BCOR	Blucora
BCOV	Brightcove
BCPC	Balchem Corp.
BCR	CR Bard Inc.
BCRH	Blue Capital Reinsurance Holdings Ltd.
BCRX	BioCryst Pharmaceuticals
BCS	Barclays PLC
BCV	Bancroft Fund Ltd.
BDBD	Boulder Brands
BDC	Belden Inc.
BDCS	UBS E-TRACS Wells Fargo Bus Dev Comp ETN
BDD	PowerShares DB Base Metals Dble Long ETN
BDE	Black Diamond
BDG	PowerShares DB Base Metals Long ETN
BDGE	Bridge Bancorp
BDJ	Blackrock Enhanced Dividend Achievers Trust
BDL	Flanigan's Enterprises Inc.
BDMS	Birner Dental Management Services Inc.
BDN	Brandywine Realty Trust
BDR	Blonder Tongue Laboratories Inc.
BDSI	BioDelivery Sciences International
BDX	Becton
BEAT	BioTelemetry
BEAV	B/E Aerospace Inc.
BEBE	Bebe Stores
BECN	Beacon Roofing Supply
BEE	Strategic Hotels & Resorts
BEL	Belmond Ltd.
BELFB	Bel Fuse Inc.
BEN	Franklin Resources Inc.
BEP	Brookfield Renewable Energy Partners LP
BERY	Berry Plastics Group
BF-B	Brown-Forman Corporation
BFAM	Bright Horizons Family Solutions
BFIN	BankFinancial Corp.
BFK	BlackRock Municipal Income Trust
BFO	BlackRock Florida Municipal 2020 Term Trust
BFOR	Barron's 400 ETF
BFR	BBVA Banco Frances S.A.
BFS	Saul Centers Inc.
BFY	BlackRock New York Municipal Income Trust II
BFZ	BlackRock California Municipal Income Trust
BG	Bunge Limited
BGC	General Cable Corp.
BGCP	BGC Partners
BGFV	Big 5 Sporting Goods Corp.
BGG	Briggs & Stratton Corporation
BGI	Birks Group Inc.
BGMD	BG Medicine
BGR	BlackRock Energy and Resources Trust
BGS	B&G Foods Inc.
BGT	BlackRock Floating Rate Income Trust
BGY	Blackrock International Growth and Income Trust
BH	Biglari Holdings Inc.
BHB	Bar Harbor Bankshares
BHE	Benchmark Electronics Inc.
BHI	Baker Hughes Incorporated
BHK	BlackRock Core Bond Trust
BHLB	Berkshire Hills Bancorp Inc.
BHP	BHP Billiton Limited
BHV	BlackRock Virginia Municipal Bond Trust
BIB	ProShares Ultra Nasdaq Biotechnology
BICK	First Trust BICK Index
BID	Sotheby's
BIDU	Baidu
BIE	BlackRock Municipal Bond Investment Trust
BIF	Boulder Growth & Income Fund Inc.
BIG	Big Lots Inc.
BIIB	Biogen Idec Inc.
BIK	SPDR S&P BRIC 40
BIL	SPDR Barclays 1-3 Month T-Bill
BIN	Progressive Waste Solutions Ltd.
BIND	BIND Therapeutics
BIO	Bio-Rad Laboratories
BIOA	BioAmber Inc.
BIOC	Biocept
BIOD	Biodel Inc.
BIOF	BioFuel Energy Corp.
BIOL	BIOLASE
BIOS	BioScrip Inc.
BIP	Brookfield Infrastructure Partners L.P.
BIRT	Actuate Corporation
BIS	ProShares UltraShort Nasdaq Biotech
BITA	Bitauto Holdings Limited
BIV	Vanguard Intermediate-Term Bond ETF
BIZD	Market Vectors BDC Income ETF
BJK	Market Vectors Gaming ETF
BJRI	BJ's Restaurants
BJZ	BlackRock California Municipal 2018 Term Trust
BK	The Bank of New York Mellon Corporation
BKCC	BlackRock Kelso Capital Corporation
BKD	Brookdale Senior Living Inc.
BKE	The Buckle
BKEP	Blueknight Energy Partners
BKF	iShares MSCI BRIC
BKH	Black Hills Corporation
BKJ	Bancorp Of New Jersey
BKK	BlackRock Municipal 2020 Term Trust
BKLN	PowerShares Senior Loan ETF
BKMU	Bank Mutual Corporation
BKN	BlackRock Investment Quality Municipal Trust Inc.
BKS	Barnes & Noble
BKSC	The Bank of South Carolina Corporation
BKT	BlackRock Income Trust
BKU	BankUnited
BKW	Burger King Worldwide
BKYF	The Bank of Kentucky Financial Corporation
BLDP	Ballard Power Systems Inc.
BLDR	Builders FirstSource
BLE	BlackRock Municipal Income Trust II
BLFS	BioLife Solutions
BLH	BlackRock New York Municipal 2018 Term Trust
BLIN	Bridgeline Digital
BLJ	BlackRock New Jersey Municipal Bond Trust
BLK	BlackRock
BLKB	Blackbaud Inc.
BLL	Ball Corporation
BLMN	Bloomin' Brands
BLMT	BSB Bancorp
BLNG	iPath Pure Beta Precious Metals ETN
BLOX	Infoblox Inc.
BLT	Blount International Inc.
BLUE	bluebird bio
BLV	Vanguard Long-Term Bond ETF
BLVD	Boulevard Acquisition Corp.
BLW	BlackRock Limited Duration Income Trust
BLX	Banco Latinoamericano de Comercio Exterior
BMA	Banco Macro S.A.
BME	BlackRock Health Sciences Trust
BMI	Badger Meter Inc.
BMO	Bank of Montreal
BMR	BioMed Realty Trust Inc.
BMRC	Bank of Marin Bancorp
BMRN	BioMarin Pharmaceutical Inc.
BMS	Bemis Company
BMTC	Bryn Mawr Bank Corp.
BMY	Bristol-Myers Squibb Company
BNA	BlackRock Income Opportunity Trust
BNCL	Beneficial Mutual Bancorp Inc.
BNCN	BNC Bancorp
BND	Vanguard Total Bond Market ETF
BNDX	Vanguard Total International Bond ETF
BNFT	Benefitfocus
BNJ	BlackRock New Jersey Municipal Income Trust
BNNY	Annie's
BNO	United States Brent Oil
BNS	The Bank of Nova Scotia
BNSO	Bonso Electronics International Inc.
BNY	BlackRock New York Municipal Income Trust
BOBE	Bob Evans Farms
BOCH	Bank of Commerce Holdings
BODY	Body Central Corp.
BOE	BlackRock Global Opportunities Equity Trust
BOFI	BofI Holding
BOH	Bank of Hawaii Corporation
BOIL	ProShares Ultra Bloomberg Natural Gas
BOKF	BOK Financial Corporation
BOLT	Bolt Technology Corp.
BOM	PowerShares DB Base Metals Dble Shrt ETN
BONA	Bona Film Group Limited
BOND	PIMCO Total Return ETF
BONE	Bacterin International Holdings
BONT	Bon-Ton Stores Inc.
BOOM	Dynamic Materials Corp.
BORN	China New Borun Corporation
BOSC	B.O.S. Better Online Solutions Ltd.
BOTA	Biota Pharmaceuticals
BOTJ	Bank of the James Financial Group Inc.
BOXC	Brookfield Canada Office Properties
BP	BP plc
BPFH	Boston Private Financial Holdings
BPHX	BluePhoenix Solutions Ltd.
BPI	Bridgepoint Education
BPK	BlackRock Municipal 2018 Term Trust
BPL	Buckeye Partners
BPOP	Popular
BPS	BlackRock Pennsylvania Strategic Municipal Trust Fund
BPT	BP Prudhoe Bay Royalty Trust
BPTH	Bio-Path Holdings
BPY	Brookfield Property Partners L.P.
BPZ	BPZ Resources
BQH	BlackRock New York Municipal Bond Trust
BQR	BlackRock Ecosolutions Investme
BQY	BlackRock S&P Quality Rankings Global Equity Managed Trust
BR	Broadridge Financial Solutions
BRAF	Global X Brazil Financials ETF
BRAQ	Global X Brazil Consumer ETF
BRAZ	Global X Brazil Mid Cap ETF
BRC	Brady Corp.
BRCD	Brocade Communications Systems
BRCM	Broadcom Corp.
BRDR	Borderfree
BREW	Craft Brew Alliance
BRF	Market Vectors Brazil Small-Cap ETF
BRFS	BRF S.A.
BRID	Bridgford Foods Corp.
BRK-A	Berkshire Hathaway Inc.
BRK-B	Berkshire Hathaway Inc.
BRKL	Brookline Bancorp
BRKR	Bruker Corporation
BRKS	Brooks Automation
BRLI	Bio-Reference Laboratories Inc.
BRN	Barnwell Industries
BRO	Brown & Brown Inc.
BRP	Brookfield Residential Properties Inc.
BRS	Bristow Group
BRSS	Global Brass and Copper Holdings
BRT	BRT Realty Trust
BRX	Brixmor Property Group Inc.
BRXX	EGShares Brazil Infrastructure
BRZS	Direxion Daily Brazil Bear 3X Shares
BRZU	Direxion Daily Brazil Bull 3X Shares
BSAC	Banco Santander-Chile
BSBR	Banco Santander
BSCE	Guggenheim BulletShrs2014 Corp Bd ETF
BSCF	Guggenheim BulletShrs2015 Corp Bd ETF
BSCG	Guggenheim BulletShrs2016 Corp Bd ETF
BSCH	Guggenheim BulletShrs2017 Corp Bd ETF
BSCI	Guggenheim BulletShrs2018 Corp Bd ETF
BSCJ	Guggenheim BulletShrs2019 Corp Bd ETF
BSCK	Guggenheim BulletShrs2020 Corp Bd ETF
BSCL	Guggenheim BulletShrs2021 Corp Bd ETF
BSCM	Guggenheim BulletShrs2022 Corp Bd ETF
BSD	BlackRock Strategic Municipal Trust
BSDM	BSD Medical Corp.
BSE	BlackRock New York Insured Municipal Income Trust
BSET	Bassett Furniture Industries
BSF	Bear State Financial
BSFT	BroadSoft
BSI	Alon Blue Square Israel Ltd
BSMX	Grupo Financiero Santander Mexico
BSP	American Strategic Income Portfolio Inc. II
BSPM	Biostar Pharmaceuticals
BSQR	BSQUARE Corp.
BSRR	Sierra Bancorp
BSTC	BioSpecifics Technologies Corp.
BSV	Vanguard Short-Term Bond ETF
BSX	Boston Scientific Corporation
BT	BT Group plc
BTA	BlackRock Long-Term Municipal Advantage Trust
BTAL	QuantShares US Market Neut Anti-Beta ETF
BTE	Baytex Energy Corp.
BTF	Boulder Total Return Fund
BTG	B2Gold Corp.
BTH	Blyth
BTI	British American Tobacco plc
BTN	Ballantyne Strong
BTO	John Hancock Bank and Thrift Opportunity Fund
BTU	Peabody Energy Corp.
BTUI	BTU International Inc.
BTX	BioTime
BTZ	BlackRock Credit Allocation Income Trust IV
BUD	Anheuser-Busch InBev SA/NV
BUND	PIMCO Germany Bond ETF
BURL	Burlington Stores
BUSE	First Busey Corporation
BV	Bazaarvoice
BVA	Cordia Bancorp Inc.
BVN	Compania de Minas Buenaventura SA
BVSN	BroadVision
BVX	Bovie Medical Corporation
BWA	BorgWarner Inc.
BWC	The Babcock & Wilcox Company
BWEN	Broadwind Energy
BWFG	Bankwell Financial Group
BWINB	Baldwin & Lyons Inc.
BWL-A	Bowl America Incorporated
BWLD	Buffalo Wild Wings Inc.
BWP	Boardwalk Pipeline Partners
BWS	Brown Shoe Co. Inc.
BWX	SPDR Barclays Capital Intl Treasury Bond
BWZ	SPDR Barclays S/T Intl Treasury Bond
BX	The Blackstone Group L.P.
BXC	Bluelinx Holdings Inc.
BXE	Bellatrix Exploration Ltd.
BXMT	Blackstone Mortgage Trust
BXP	Boston Properties Inc.
BXS	BancorpSouth
BYBK	Bay Bancorp
BYD	Boyd Gaming Corporation
BYFC	Broadway Financial Corporation
BYI	Bally Technologies
BYLD	iShares Yield Optimized Bond
BYLK	Baylake Corp.
BYM	BlackRock Insured Municipal Income Trust
BZC	Breeze-Eastern Corporation
BZF	WisdomTree Brazilian Real Strategy
BZH	Beazer Homes USA Inc.
BZM	BlackRock Maryland Municipal Bond Trust
BZQ	ProShares UltraShort MSCI Brazil Capped
C	Citigroup Inc.
CA	CA Technologies
CAAS	China Automotive Systems Inc.
CAB	Cabela's Incorporated
CAC	Camden National Corp.
CACB	Cascade Bancorp
CACC	Credit Acceptance Corp.
CACG	Chart Acquisition Corp.
CACH	Cache Inc.
CACI	CACI International Inc.
CACQ	Caesars Acquisition Company
CAD	PIMCO Canada Bond ETF
CADC	China Advanced Construction Materials Group
CAE	CAE Inc.
CAF	Morgan Stanley China A Share Fu
CAFE	iPath Pure Beta Coffee ETN
CAG	ConAgra Foods
CAH	Cardinal Health
CAJ	Canon Inc.
CAK	CAMAC Energy
CAKE	The Cheesecake Factory Incorporated
CALD	Callidus Software Inc.
CALI	China Auto Logistic Inc.
CALL	magicJack VocalTec Ltd.
CALM	Cal-Maine Foods
CALX	Calix Inc.
CAM	Cameron International Corporation
CAMP	CalAmp Corp.
CAMT	Camtek Ltd.
CANE	Teucrium Sugar ETF
CANF	Can-Fite BioPharma Ltd.
CAP	CAI International Inc.
CAR	Avis Budget Group
CARA	Cara Therapeutics Inc.
CARB	Carbonite
CARO	Carolina Financial Corpration
CART	Carolina Trust Bank
CARV	Carver Bancorp
CARZ	First Trust NASDAQ Global Auto Index
CAS	A. M. Castle & Co.
CASH	Meta Financial Group
CASI	CASI Pharmaceuticals
CASM	CAS Medical Systems Inc.
CASS	Cass Information Systems
CASY	Casey's General Stores
CAT	Caterpillar Inc.
CATM	Cardtronics Inc.
CATO	The Cato Corporation
CATY	Cathay General Bancorp
CAVM	Cavium
CAW	CCA Industries Inc.
CB	The Chubb Corporation
CBAK	China BAK Battery
CBAN	Colony Bankcorp Inc.
CBB	Cincinnati Bell Inc.
CBD	Companhia Brasileira de Distribuicao
CBDE	CBD Energy Limited
CBF	Capital Bank Financial Corp.
CBG	CBRE Group
CBI	Chicago Bridge & Iron Company N.V.
CBIN	Community Bank Shares of Indiana Inc.
CBK	Christopher & Banks Corporation
CBL	CBL & Associates Properties Inc.
CBLI	Cleveland BioLabs
CBM	Cambrex Corporation.
CBMX	CombiMatrix Corporation
CBND	SPDR Barclays Cap Issuer Scd Corp Bond
CBNJ	Cape Bancorp
CBNK	Chicopee Bancorp
CBOE	CBOE Holdings
CBPO	China Biologic Products
CBPX	Continental Building Products
CBR	Ciber
CBRL	Cracker Barrel Old Country Store
CBRX	Columbia Laboratories Inc.
CBS	CBS Corporation
CBSH	Commerce Bancshares
CBSO	CBS Outdoor Americas Inc.
CBST	Cubist Pharmaceuticals Inc.
CBT	Cabot Corporation
CBU	Community Bank System Inc.
CBZ	CBIZ
CCA	MFS California Insured Municipal Fund
CCBG	Capital City Bank Group Inc.
CCC	Calgon Carbon Corporation
CCCL	China Ceramics Co.
CCCR	China Commercial Credit
CCE	Coca-Cola Enterprises Inc.
CCF	Chase Corporation
CCG	Campus Crest Communities
CCI	Crown Castle International Corp.
CCIH	ChinaCache International Holdings Ltd.
CCJ	Cameco Corporation
CCK	Crown Holdings Inc.
CCL	Carnival Corporation
CCM	Concord Medical Services Holdings Limited
CCMP	Cabot Microelectronics Corporation
CCNE	CNB Financial Corp.
CCO	Clear Channel Outdoor Holdings Inc.
CCOI	Cogent Communications Holdings
CCRN	Cross Country Healthcare
CCS	Century Communities
CCSC	Country Style Cooking Restaurant Chain Co.
CCU	Compania Cervecerias Unidas S.A.
CCUR	Concurrent Computer Corporation
CCX	WisdomTree Commodity Currency Strat
CCXE	WisdomTree Commodity Country Equity ETF
CCXI	ChemoCentryx
CDE	Coeur Mining
CDI	CDI Corp.
CDNS	Cadence Design Systems Inc.
CDR	Cedar Realty Trust
CDTI	Clean Diesel Technologies Inc.
CDW	CDW Corporation
CDXS	Codexis
CDZI	Cadiz Inc.
CE	Celanese Corporation
CEA	China Eastern Airlines Corp. Ltd.
CEB	Corporate Executive Board Co.
CECE	CECO Environmental Corp.
CECO	Career Education Corp.
CEE	Central Europe & Russia Fund Inc.
CEF	Central Fund of Canada Limited
CEL	Cellcom Israel Ltd.
CELG	Celgene Corporation
CELP	Cypress Energy Partners
CEMI	Chembio Diagnostics
CEMP	Cempra
CENT	Central Garden & Pet Company
CENX	Century Aluminum Co.
CEO	CNOOC Ltd.
CEP	Constellation Energy Partners LLC
CEQP	Crestwood Equity Partners LP
CERE	Ceres
CERN	Cerner Corporation
CERS	Cerus Corporation
CERU	Cerulean Pharma Inc.
CET	Central Securities Corp.
CETV	Central European Media Enterprises Ltd.
CEV	Eaton Vance California Municipal Income Trust
CEVA	CEVA Inc.
CEW	WisdomTree Emerging Currency Strategy
CF	CF Industries Holdings
CFBK	Central Federal Corp.
CFFI	C&F Financial Corp.
CFFN	Capitol Federal Financial
CFI	Culp
CFN	CareFusion Corporation
CFNB	California First National Bancorp
CFNL	Cardinal Financial Corp.
CFP	Cornerstone Progressive Return 
CFR	Cullen/Frost Bankers
CFX	Colfax Corporation
CG	The Carlyle Group LP
CGA	China Green Agriculture
CGEN	Compugen Ltd.
CGG	CGG SA
CGI	Celadon Group Inc.
CGNX	Cognex Corporation
CGO	Calamos Global Total Return Fund
CGW	Guggenheim S&P Global Water ETF
CH	Aberdeen Chile Fund
CHA	China Telecom Corp. Ltd.
CHCI	Comstock Holding Companies
CHCO	City Holding Co.
CHD	Church & Dwight Co. Inc.
CHDN	Churchill Downs Inc.
CHDX	Chindex International Inc.
CHE	Chemed Corp.
CHEF	The Chefs' Warehouse
CHEP	QuantShares US Market Neutral Value ETF
CHEV	Cheviot Financial Corp.
CHFC	Chemical Financial Corporation
CHFN	Charter Financial Corporation
CHGG	Chegg
CHH	Choice Hotels International Inc.
CHI	Calamos Convertible Opportunities & Income Fund
CHIE	Global X China Energy ETF
CHII	Global X China Industrials ETF
CHIM	Global X China Materials ETF
CHIQ	Global X China Consumer ETF
CHIX	Global X China Financials ETF
CHK	Chesapeake Energy Corporation
CHKE	Cherokee Inc.
CHKP	Check Point Software Technologies Ltd.
CHKR	Chesapeake Granite Wash Trust
CHL	China Mobile Limited
CHLC	Market Vectors Renminbi Bond ETF
CHLN	China Housing and Land Development
CHMG	Chemung Financial Corporation
CHMI	Cherry Hill Mortgage Investment Corporation
CHMT	Chemtura Corporation
CHN	China Fund
CHNA	PowerShares China A-Share ETF
CHNR	China Natural Resources Inc.
CHOC	iPath Pure Beta Cocoa ETN
CHOP	China Gerui Advanced Materials Group Ltd.
CHRM	Charm Communications Inc.
CHRW	CH Robinson Worldwide Inc.
CHS	Chico's FAS Inc.
CHSCP	CHS
CHSP	Chesapeake Lodging Trust
CHT	Chunghwa Telecom Co.
CHTR	Charter Communications
CHU	China Unicom
CHUY	Chuy's Holdings
CHW	Calamos Global Dynamic Income Fund
CHXF	WisdomTree China Dividend ex-Financials
CHXX	EGShares China Infrastructure
CHY	Calamos Convertible & High Income Fund
CHYR	ChyronHego Corp.
CI	Cigna Corp.
CIA	Citizens Inc.
CIB	Bancolombia S.A.
CIDM	Cinedigm Corp.
CIE	Cobalt International Energy
CIEN	Ciena Corporation
CIF	MFS Intermediate High Income Fund
CIFC	CIFC Corp.
CIG	Cia Energetica de Minas Gerais
CII	BlackRock Enhanced Capital and Income Fund
CIK	Credit Suisse Asset Management Income Fund Inc.
CIM	Chimera Investment Corporation
CIMT	Cimatron Ltd.
CINF	Cincinnati Financial Corp.
CIO	City Office Reit
CIR	CIRCOR International
CISAA	CIS Acquisition Ltd.
CISG	Cninsure Inc.
CIT	CIT Group Inc.
CIU	iShares Intermediate Credit Bd
CIX	CompX International Inc.
CIZN	Citizens Holding Company
CJES	C&J Energy Services
CJJD	China Jo-Jo Drugstores
CKEC	Carmike Cinemas Inc.
CKH	Seacor Holdings Inc.
CKP	Checkpoint Systems Inc.
CKSW	ClickSoftware Technologies Ltd.
CKX	CKX Lands Inc.
CL	Colgate-Palmolive Co.
CLB	Core Laboratories NV
CLBH	Carolina Bank Holdings Inc.
CLC	CLARCOR Inc.
CLCT	Collectors Universe Inc.
CLD	Cloud Peak Energy Inc.
CLDN	Celladon Corporation
CLDT	Chatham Lodging Trust
CLDX	Celldex Therapeutics
CLF	Cliffs Natural Resources Inc.
CLFD	Clearfield
CLGX	CoreLogic
CLH	Clean Harbors
CLI	Mack-Cali Realty Corp.
CLIR	Clearsign Combustion Corp.
CLM	Cornerstone Strategic Value Fund Inc.
CLMS	Calamos Asset Management Inc.
CLMT	Calumet Specialty Products Partners LP
CLNE	Clean Energy Fuels Corp.
CLNT	Cleantech Solutions International
CLNY	Colony Financial
CLR	Continental Resources
CLRO	ClearOne
CLRX	CollabRx
CLS	Celestica Inc.
CLSN	Celsion Corp.
CLTX	Celsus Therapeutics Plc
CLUB	Town Sports International Holdings Inc.
CLVS	Clovis Oncology
CLW	Clearwater Paper Corporation
CLWT	Euro Tech Holdings Company Limited
CLX	The Clorox Company
CLY	iShares 10+ Year Credit Bond
CM	Canadian Imperial Bank of Commerce
CMA	Comerica Incorporated
CMBS	iShares CMBS
CMC	Commercial Metals Company
CMCM	Cheetah Mobile Inc.
CMCO	Columbus McKinnon Corporation
CMCSA	Comcast Corporation
CMCT	CIM Commercial Trust Corporation
CMD	ProShares UltraShort Bloomberg Commodity
CMDT	iShares Commodity Optimized Trust
CME	CME Group Inc.
CMF	iShares Cali AMT-Free Muni Bond
CMG	Chipotle Mexican Grill
CMGE	China Mobile Games and Entertainment Group Limited
CMI	Cummins Inc.
CMK	MFS Intermarket Income Trust I 
CMLP	Crestwood Midstream Partners LP
CMLS	Cumulus Media Inc.
CMN	Cantel Medical Corp.
CMO	Capstead Mortgage Corp.
CMP	Compass Minerals International Inc.
CMRE	Costamare Inc.
CMRX	Chimerix
CMS	CMS Energy Corp.
CMSB	CMS Bancorp
CMT	Core Molding Technologies Inc.
CMTL	Comtech Telecommunications Corp.
CMU	MFS High Yield Municipal Trust
CN	Deutsche X-trackers Hrvst MSCI AllCHN Eq
CNA	CNA Financial Corporation
CNAT	Conatus Pharmaceuticals Inc.
CNBKA	Century Bancorp Inc.
CNC	Centene Corp.
CNCE	Concert Pharmaceuticals
CNCO	Cencosud S.A.
CNDA	IQ Canada Small Cap ETF
CNDO	Coronado Biosciences
CNET	ChinaNet Online Holdings
CNHI	CNH Industrial N.V.
CNI	Canadian National Railway Company
CNIT	China Information Technology
CNK	Cinemark Holdings Inc.
CNL	Cleco Corporation
CNMD	CONMED Corporation
CNO	CNO Financial Group
CNOB	ConnectOne Bancorp
CNP	CenterPoint Energy
CNPF	Global X Canada Preferred ETF
CNQ	Canadian Natural Resources Limited
CNQR	Concur Technologies
CNR	China Metro-Rural Holdings Limited
CNS	Cohen & Steers Inc.
CNSI	Comverse
CNSL	Consolidated Communications Holdings Inc.
CNTF	China Techfaith Wireless Communication Technology Limited
CNTY	Century Casinos Inc.
CNVR	Conversant
CNW	Con-way Inc.
CNX	CONSOL Energy Inc.
CNXT	Market Vectors ChinaAMC SME-ChiNext ETF
CNY	Market Vectors Chinese Renminbi/USD ETN
CNYD	China Yida Holding
CO	China Cord Blood Corporation
COB	CommunityOne Bancorp
COBK	Colonial Financial Services
COBR	Cobra Electronics Corp.
COBZ	CoBiz Financial Inc.
COCO	Corinthian Colleges Inc.
CODE	Spansion Inc.
CODI	Compass Diversified Holdings
COF	Capital One Financial Corporation
COG	Cabot Oil & Gas Corporation
COH	Coach
COHR	Coherent Inc.
COHU	Cohu
COKE	Coca-Cola Bottling Co. Consolidated
COL	Rockwell Collins Inc.
COLB	Columbia Banking System Inc.
COLM	Columbia Sportswear Company
COMM	CommScope Holding Company
CONE	Cyrusone Inc.
CONN	Conns Inc.
COO	The Cooper Companies Inc.
COOL	Majesco Entertainment Co.
COP	ConocoPhillips
COPX	Global X Copper Miners ETF
COR	CoreSite Realty Corporation
CORE	Core-Mark Holding Company
CORI	Corium International
CORN	Teucrium Corn ETF
CORP	PIMCO Investment Grade Corporate Bd ETF
CORR	CorEnergy Infrastructure Trust
CORT	Corcept Therapeutics Incorporated
COSI	Cosi Inc.
COST	Costco Wholesale Corporation
COT	Cott Corporation
COTY	Coty Inc.
COUP	Coupons.com Incorporated
COV	Covidien plc
COVR	Cover-All Technologies Inc.
COVS	Covisint Corporation
COW	iPath DJ-UBS Livestock TR Sub-Idx ETN
COWN	Cowen Group
CP	Canadian Pacific Railway Limited
CPA	Copa Holdings SA
CPAC	Cementos Pacasmayo SAA
CPB	Campbell Soup Company
CPE	Callon Petroleum Company
CPER	United States Copper
CPF	Central Pacific Financial Corp.
CPG	Crescent Point Energy Corp.
CPGI	China  Shengda Packaging  Group Inc.
CPHC	Canterbury Park Holding Corporation
CPHD	Cepheid
CPHI	China Pharma Holdings
CPI	IQ Real Return ETF
CPIX	Cumberland Pharmaceuticals
CPK	Chesapeake Utilities Corporation
CPL	CPFL Energia S.A.
CPLA	Capella Education Co.
CPLP	Capital Product Partners L.P.
CPN	Calpine Corp.
CPRT	Copart
CPRX	Catalyst Pharmaceutical Partners Inc.
CPS	Cooper-Standard Holdings Inc.
CPSI	Computer Programs & Systems Inc.
CPSL	China Precision Steel
CPSS	Consumer Portfolio Services
CPST	Capstone Turbine Corp.
CPT	Camden Property Trust
CPTA	Capitala Finance Corp.
CPWR	Compuware Corporation
CPXX	Celator Pharmaceuticals
CQB	Chiquita Brands International Inc.
CQH	Cheniere Energy Partners LP Holdings
CQP	Cheniere Energy Partners LP.
CQQQ	Guggenheim China Technology ETF
CR	Crane Co.
CRAI	CRA International Inc.
CRAY	Cray Inc.
CRBQ	Global Commodity Equity ETF
CRCM	Care.com
CRD-B	Crawford & Company
CRDC	Cardica Inc.
CRDS	Crossroads Systems
CRED	iShares Core US Credit Bond
CREE	Cree
CREG	China Recycling Energy Corporation
CRESY	Cresud Sociedad An
CRF	Cornerstone Total Return Fund
CRH	CRH plc
CRI	Carter's
CRIS	Curis
CRK	Comstock Resources Inc.
CRL	Charles River Laboratories International
CRM	Salesforce.com
CRMD	CorMedix
CRME	Cardiome Pharma Corp.
CRMT	America's Car-Mart Inc.
CRNT	Ceragon Networks Ltd.
CROX	Crocs
CRR	CARBO Ceramics Inc.
CRRC	Courier Corporation
CRRS	Corporate Resource Services
CRS	Carpenter Technology Corp.
CRT	Cross Timbers Royalty Trust
CRTN	Cartesian
CRTO	Criteo SA
CRUD	Teucrium WTI Crude Oil ETF
CRUS	Cirrus Logic Inc.
CRV	Coast Distribution System Inc.
CRVL	CorVel Corporation
CRVP	Crystal Rock Holdings
CRWN	Crown Media Holdings Inc.
CRWS	Crown Crafts
CRY	CryoLife Inc.
CRZO	Carrizo Oil & Gas Inc.
CS	Credit Suisse Group AG
CSBK	Clifton Bancorp Inc.
CSC	Computer Sciences Corporation
CSCD	Cascade Microtech Inc.
CSCO	Cisco Systems
CSD	Guggenheim Spin-Off ETF
CSFL	CenterState Banks
CSG	Chambers Street Properties
CSGP	CoStar Group Inc.
CSGS	CSG Systems International Inc.
CSH	Cash America International
CSII	Cardiovascular Systems Inc.
CSIQ	Canadian Solar Inc.
CSJ	iShares 1-3 Year Credit Bond
CSL	Carlisle Companies Incorporated
CSLS	Credit Suisse Long/Short Liquid Idx ETN
CSLT	Castlight Health
CSM	ProShares Large Cap Core Plus
CSMA	Credit Suisse Merger Arbi Liquid Idx ETN
CSMB	Credit Suisse 2X Merger Arbi Lqd Idx ETN
CSMN	Credit Suisse Market Neut Global Eq ETN
CSOD	Cornerstone OnDemand
CSP	American Strategic Income Portfolio III
CSPI	CSP Inc.
CSQ	Calamos Strategic Total Return 
CSS	CSS Industries Inc.
CST	CST Brands
CSTE	CaesarStone Sdot-Yam Ltd.
CSTM	Constellium N.V
CSU	Capital Senior Living Corp.
CSUN	China Sunergy Co. Ltd.
CSV	Carriage Services Inc.
CSWC	Capital Southwest Corporation
CSX	CSX Corp.
CTAS	Cintas Corporation
CTB	Cooper Tire & Rubber Co.
CTBI	Community Trust Bancorp Inc.
CTC	IFM Investments Limited
CTCM	CTC Media
CTCT	Constant Contact
CTG	Computer Task Group Inc.
CTHR	Charles & Colvard Ltd.
CTIB	CTI Industries Corp.
CTIC	CTI BioPharma Corp.
CTL	CenturyLink
CTNN	iPath Pure Beta Cotton ETN
CTO	Consolidated Tomoka Land Co.
CTP	CTPartners Executive Search Inc.
CTRL	Control4 Corporation
CTRN	Citi Trends
CTRP	Ctrip.com International Ltd.
CTRX	Catamaran Corporation
CTS	CTS Corporation
CTSH	Cognizant Technology Solutions Corporation
CTT	CatchMark Timber Trust
CTWS	Connecticut Water Service Inc.
CTXS	Citrix Systems
CU	First Trust ISE Global Copper Index
CUB	Cubic Corporation
CUBA	Herzfeld Caribbean Basin Fund Inc.
CUBE	CubeSmart
CUBI	Customers Bancorp
CUDA	Barracuda Networks
CUI	CUI Global
CUK	Carnival plc
CUNB	CU Bancorp
CUO	Continental Materials Corp.
CUPM	iPath Pure Beta Copper ETN
CUR	Neuralstem
CURE	Direxion Daily Healthcare Bull 3X Shares
CUT	Guggenheim Timber ETF
CUTR	Cutera
CUZ	Cousins Properties Incorporated
CVA	Covanta Holding Corporation
CVBF	CVB Financial Corp.
CVC	Cablevision Systems Corporation
CVCO	Cavco Industries
CVCY	Central Valley Community Bancorp
CVD	Covance Inc.
CVE	Cenovus Energy Inc.
CVEO	Civeo Corporation
CVG	Convergys Corporation
CVGI	Commercial Vehicle Group Inc.
CVGW	Calavo Growers Inc.
CVI	CVR Energy
CVLT	CommVault Systems
CVLY	Codorus Valley Bancorp Inc.
CVM	CEL-SCI Corporation
CVO	Cenveo Inc.
CVOL	C-Tracks Citi Volatility Index TR ETN
CVR	Chicago Rivet & Machine Co.
CVRR	CVR Refining
CVS	CVS Caremark Corporation
CVT	Cvent
CVTI	Covenant Transportation Group
CVU	CPI Aerostructures Inc.
CVV	CVD Equipment Corporation
CVX	Chevron Corporation
CVY	Guggenheim Multi-Asset Income ETF
CW	Curtiss-Wright Corporation
CWB	SPDR Barclays Capital Convertible Secs
CWBC	Community West Bancshares
CWCO	Consolidated Water Co. Ltd.
CWEI	Clayton Williams Energy
CWI	SPDR MSCI ACWI
CWST	Casella Waste Systems Inc.
CWT	California Water Service Group
CX	CEMEX
CXA	SPDR Nuveen Barclays Capital CA Muni Bd
CXDC	China XD Plastics Company Ltd.
CXE	MFS High Income Municipal Trust
CXH	MFS Investment Grade Municipal Trust
CXO	Concho Resources
CXP	Columbia Property Trust
CXW	Corrections Corporation of America
CY	Cypress Semiconductor Corporation
CYAN	Cyanotech Corp.
CYB	WisdomTree Chinese Yuan Strategy
CYBE	CyberOptics Corp.
CYBX	Cyberonics Inc.
CYCC	Cyclacel Pharmaceuticals
CYD	China Yuchai International Limited
CYH	Community Health Systems
CYN	City National Corporation
CYNI	Cyan
CYNO	Cynosure
CYOU	Changyou.com Limited
CYRN	CYREN Ltd.
CYS	CYS Investments
CYT	Cytec Industries Inc.
CYTK	Cytokinetics
CYTR	CytRx Corporation
CYTX	Cytori Therapeutics
CZA	Guggenheim Mid-Cap Core ETF
CZFC	Citizens First Corporation
CZNC	Citizens & Northern Corp.
CZR	Caesars Entertainment Corporation
CZWI	Citizens Community Bancorp
CZZ	Cosan Ltd.
D	Dominion Resources
DAC	Danaos Corporation
DAEG	Daegis Inc.
DAG	PowerShares DB Agriculture Dble Long ETN
DAIO	Data I/O Corp.
DAKT	Daktronics Inc.
DAL	Delta Air Lines Inc.
DAN	Dana Holding Corporation
DANG	E-Commerce China Dangdang Inc.
DAR	Darling Ingredients Inc.
DARA	DARA BioSciences
DATA	Tableau Software
DATE	Jiayuan.com International Ltd.
DAVE	Famous Dave's of America Inc.
DB	Deutsche Bank AG
DBA	PowerShares DB Agriculture ETF
DBAP	Deutsche X-trackers MSCIAsPac exJpn H Eq
DBAW	Deutsche X-trackers MSCIAllWld exUS H Eq
DBB	PowerShares DB Base Metals ETF
DBBR	Deutsche X-trackers MSCI Brazil Hdgd Eq
DBC	PowerShares DB Commodity Tracking ETF
DBD	Diebold
DBE	PowerShares DB Energy ETF
DBEF	Deutsche X-trackers MSCI EAFE Hedged Eq
DBEM	Deutsche X-trackers MSCI Em Mkts Hdgd Eq
DBEU	db X-trackers MSCI Europe Hdgd Eq ETF
DBGR	db X-trackers MSCI Germany Hedged Eq ETF
DBIZ	AdvisorShares Pring Turner Bus Cycle ETF
DBJP	Deutsche X-trackers MSCI Japan Hedged Eq
DBMX	Concentradora Fibra Hotelera Mexicana
DBO	PowerShares DB Oil ETF
DBP	PowerShares DB Precious Metals ETF
DBS	PowerShares DB Silver ETF
DBU	WisdomTree Global ex-US Utilities
DBV	PowerShares DB G10 Currency Harvest ETF
DCA	Virtus Total Return Fund
DCI	Donaldson Company
DCIN	Digital Cinema Destinations Corp.
DCIX	Diana Containerships Inc.
DCM	NTT DOCOMO
DCO	Ducommun Inc.
DCOM	Dime Community Bancshares Inc.
DCT	DCT Industrial Trust Inc.
DCTH	Delcath Systems
DD	E. I. du Pont de Nemours and Company
DDC	Dominion Diamond Corporation
DDD	3D Systems Corporation
DDE	Dover Downs Gaming & Entertainment Inc.
DDF	Delaware Investments Dividend & Income Fund
DDG	ProShares Short Oil & Gas
DDM	ProShares Ultra Dow30
DDP	PowerShares DB Commodity Short ETN
DDR	DDR Corp.
DDS	Dillard's Inc.
DE	Deere & Company
DECK	Deckers Outdoor Corp.
DEE	PowerShares DB Commodity Double Shrt ETN
DEF	Guggenheim Defensive Equity ETF
DEFL	PowerShares DB US Deflation ETN
DEG	Etablissements Delhaize Freres et Cie Le Lion S.A.
DEI	Douglas Emmett Inc
DEJ	Dejour Energy Inc.
DEL	Deltic Timber Corporation
DEM	WisdomTree Emerging Markets Equity Inc
DENN	Denny's Corporation
DEO	Diageo plc
DEPO	DepoMed Inc.
DES	WisdomTree SmallCap Dividend
DEST	Destination Maternity Corporation
DEW	WisdomTree Global Equity Income
DEX	Delaware Enhanced Global Divide
DF	Dean Foods Company
DFE	WisdomTree Europe SmallCap Dividend
DFJ	WisdomTree Japan SmallCap Dividend
DFRG	Del Frisco's Restaurant Group
DFS	Discover Financial Services
DFT	DuPont Fabros Technology
DFVL	iPath US Treasury 5-year Bull ETN
DFVS	iPath US Treasury 5-year Bear ETN
DFZ	R.G. Barry Corporation
DG	Dollar General Corporation
DGAS	Delta Natural Gas Company
DGAZ	VelocityShares 3x Inv Natural Gas ETN
DGI	DigitalGlobe
DGICB	Donegal Group Inc.
DGII	Digi International Inc.
DGL	PowerShares DB Gold ETF
DGLY	Digital Ally Inc.
DGP	PowerShares DB Gold Double Long ETN
DGRE	WisdomTree Emerging Markets Dividend Gr
DGRO	iShares Core Dividend Growth
DGRW	WisdomTree US Dividend Growth
DGS	WisdomTree Emerging Markets SmallCap Div
DGSE	DGSE Companies Inc.
DGT	SPDR Global Dow ETF
DGX	Quest Diagnostics Inc.
DGZ	PowerShares DB Gold Short ETN
DHF	Dreyfus High Yield Strategies Fund
DHG	Deutsche High Income Opportunit
DHI	DR Horton Inc.
DHIL	Diamond Hill Investment Group Inc.
DHR	Danaher Corp.
DHRM	Dehaier Medical Systems Limited
DHS	WisdomTree Equity Income
DHT	DHT Holdings
DHX	Dice Holdings
DHY	Credit Suisse High Yield Bond Fund
DIA	SPDR Dow Jones Industrial Average
DIG	ProShares Ultra Oil & Gas
DIM	WisdomTree International MidCap Div
DIN	DineEquity
DIOD	Diodes Incorporated
DIRT	iPath Pure Beta Agriculture ETN
DIS	The Walt Disney Company
DISCA	Discovery Communications
DISH	Dish Network Corp.
DIT	AMCON Distributing Co.
DIV	Global X SuperDividend US ETF
DIVI	AdvisorShares Athena High Dividend ETF
DJCI	UBS E-TRACS Bloomberg Cmdty Idx TR ETN
DJCO	Daily Journal Corp.
DJP	iPath DJ-UBS Commodity Index TR ETN
DK	Delek US Holdings
DKL	Delek Logistics Partners
DKS	Dick's Sporting Goods Inc.
DL	China Distance Education Holdings Limited
DLA	Delta Apparel Inc.
DLB	Dolby Laboratories
DLBL	iPath US Treasury Long Bond Bull ETN
DLBS	iPath US Treasury Long Bond Bear ETN
DLHC	DLH Holdings Corp.
DLIA	dELiA*s
DLN	WisdomTree LargeCap Dividend
DLNG	Dynagas LNG Partners LP
DLPH	Delphi Automotive PLC
DLR	Digital Realty Trust Inc.
DLS	WisdomTree International SmallCap Div
DLTR	Dollar Tree
DLX	Deluxe Corp.
DMD	Demand Media
DMF	Dreyfus Municipal Income
DMLP	Dorchester Minerals LP
DMND	Diamond Foods
DMRC	Digimarc Corporation
DNB	Dun & Bradstreet Corp.
DNBF	DNB Financial Corp.
DNDN	Dendreon Corp.
DNI	Dividend and Income Fund Common
DNKN	Dunkin' Brands Group
DNL	WisdomTree Global ex-US Dividend Gr ETF
DNN	Denison Mines Corp.
DNO	United States Short Oil
DNOW	NOW Inc.
DNP	DNP Select Income Fund Inc.
DNR	Denbury Resources Inc.
DNY	The Denali Fund Inc.
DO	Diamond Offshore Drilling
DOC	Physicians Realty Trust
DOD	ELEMENTS DJ High Yield Select 10 ETN
DOG	ProShares Short Dow30
DOL	WisdomTree International LargeCap Div
DOM	Dominion Resources Black Warrior Trust
DON	WisdomTree MidCap Dividend
DOO	WisdomTree International Div ex-Fincls
DOOR	Masonite International Corporation
DORM	Dorman Products
DOV	Dover Corporation
DOVR	Dover Saddlery
DOW	The Dow Chemical Company
DOX	Amdocs Limited
DPD	Dow 30 Premium & Dividend Income Fund Inc.
DPK	Direxion Daily Dev Mkts Bear 3X Shrs
DPM	DCP Midstream Partners LP
DPO	Dow 30 Premium Dow 30 Enhanced 
DPRX	Dipexium Pharmaceuticals
DPS	Dr Pepper Snapple Group
DPW	Digital Power Corp.
DPZ	Domino's Pizza
DQ	Daqo New Energy Corp.
DRAD	Digirad Corporation
DRAM	Dataram Corporation
DRC	Dresser-Rand Group Inc.
DRD	DRDGOLD Ltd.
DRE	Duke Realty Corporation
DRGS	RBS Global Big Pharma ETN
DRH	Diamondrock Hospitality Co.
DRI	Darden Restaurants
DRII	Diamond Resorts International
DRIV	Digital River Inc.
DRL	Doral Financial Corporation
DRN	Direxion Daily Real Estate Bull 3X Shrs
DRNA	Dicerna Pharmaceuticals
DRQ	Dril-Quip
DRR	Market Vectors Double Short Euro ETN
DRRX	DURECT Corporation
DRTX	Durata Therapeutics
DRV	Direxion Daily Real Estate Bear 3X Shrs
DRW	WisdomTree Global ex-US Real Estate
DRWI	DragonWave Inc.
DRYS	DryShips
DSCI	Derma Sciences Inc.
DSCO	Discovery Laboratories Inc.
DSGX	The Descartes Systems Group Inc
DSI	iShares MSCI KLD 400 Social
DSKX	DS Healthcare Group
DSM	Dreyfus Strategic Municipal Bond Fund Inc.
DSPG	DSP Group Inc.
DSS	Document Security Systems
DST	DST Systems Inc.
DSTJ	JPMorgan 2X Short US Long Trsy Fut ETN
DSU	BlackRock Debt Strategies Fund
DSUM	PowerShares Chinese Yuan Dim Sum Bd ETF
DSW	DSW Inc.
DSWL	Deswell Industries
DSX	Diana Shipping Inc.
DSXJ	JPMorgan 2X Short US 10 Yr Trsy Fut ETN
DTD	WisdomTree Total Dividend
DTE	DTE Energy Company
DTF	DTF Tax-Free Income Inc.
DTH	WisdomTree DEFA Equity Income
DTLK	Datalink Corporation
DTN	WisdomTree Dividend ex-Financials
DTO	PowerShares DB Crude Oil Double Shrt ETN
DTSI	DTS Inc.
DTUL	iPath US Treasury 2-year Bull ETN
DTUS	iPath US Treasury 2-year Bear ETN
DTV	DIRECTV
DTYL	iPath US Treasury 10-year Bull ETN
DTYS	iPath US Treasury 10-year Bear ETN
DUC	Duff & Phelps Utility & Corporate Bond Trust Inc.
DUG	ProShares UltraShort Oil & Gas
DUK	Duke Energy Corporation
DUST	Direxion Daily Gold Miners Bear 3X Shrs
DV	DeVry Education Group Inc.
DVA	DaVita HealthCare Partners Inc.
DVAX	Dynavax Technologies Corporation
DVCR	Diversicare Healthcare Services Inc.
DVD	Dover Motorsports Inc.
DVN	Devon Energy Corporation
DVR	Cal Dive International Inc
DVY	iShares Select Dividend
DVYA	iShares Asia/Pacific Dividend
DVYE	iShares Emerging Markets Dividend
DVYL	UBS E-TRACS Mo Pay 2x DJ Select Div ETN
DW	Drew Industries Incorporated
DWA	DreamWorks Animation SKG Inc.
DWAQ	PowerShares DWA NASDAQ Momentum ETF
DWCH	Datawatch Corporation
DWM	WisdomTree DEFA
DWRE	Demandware
DWSN	Dawson Geophysical Company
DWTI	VelocityShares 3x Inverse Crude ETN
DWX	SPDR S&P International Dividend
DX	Dynex Capital Inc.
DXCM	DexCom
DXD	ProShares UltraShort Dow30
DXGE	WisdomTree Germany Hedged Equity
DXJ	WisdomTree Japan Hedged Equity
DXKW	WisdomTree Korea Hedged Equity
DXLG	Destination XL Group
DXM	Dex Media
DXPE	DXP Enterprises
DXR	Daxor Corp.
DXYN	The Dixie Group
DY	Dycom Industries Inc.
DYAX	Dyax Corp.
DYN	Dynegy Inc.
DYNT	Dynatronics Corp.
DYSL	Dynasil Corporation of America
DYY	PowerShares DB Commodity Double Long ETN
DZK	Direxion Daily Dev Mkts Bull 3X Shrs
DZZ	PowerShares DB Gold Double Short ETN
E	Eni SpA
EA	Electronic Arts Inc.
EAC	Erickson Incorporated
EAD	Wells Fargo Advantage Income Opportunities Fund
EAGL	Silver Eagle Acquisition Corp.
EARN	Ellington Residential Mortgage REIT
EAT	Brinker International
EBAY	eBay Inc.
EBF	Ennis Inc.
EBIO	Eleven Biotherapeutics
EBIX	Ebix Inc.
EBMT	Eagle Bancorp Montana
EBND	SPDR Barclays Capital EM Local Bond ETF
EBR	Centrais Electricas Brasileiras S.A.
EBS	Emergent BioSolutions
EBSB	Meridian Bancorp
EBTC	Enterprise Bancorp Inc.
EC	Ecopetrol SA
ECA	Encana Corporation
ECF	Ellsworth Fund Ltd.
ECH	iShares MSCI Chile Capped
ECHO	Echo Global Logistics
ECL	Ecolab Inc.
ECNS	iShares MSCI China Small Cap
ECOL	US Ecology
ECOM	ChannelAdvisor Corporation
ECON	EGShares Emerging Markets Consumer
ECPG	Encore Capital Group
ECT	ECA Marcellus Trust I
ECTE	Echo Therapeutics
ECYT	Endocyte
ED	Consolidated Edison
EDAP	EDAP TMS SA
EDC	Direxion Daily Emrg Mkts Bull 3X Shares
EDD	Morgan Stanley Emerging Markets
EDE	The Empire District Electric Company
EDEN	iShares MSCI Denmark Capped
EDGW	Edgewater Technology Inc.
EDIV	SPDR S&P Emerging Markets Dividend
EDMC	Education Management Corporation
EDN	Empresa Distribuidora y Comercializadora Norte S.A.
EDOG	ALPS Emerging Sector Dividend Dogs ETF
EDR	Education Realty Trust
EDS	Exceed Company Ltd.
EDU	New Oriental Education & Technology Group Inc.
EDUC	Educational Development Corporation
EDV	Vanguard Extended Duration Treasury ETF
EDZ	Direxion Daily Emrg Mkts Bear 3X Shares
EE	El Paso Electric Co.
EEA	The European Equity Fund
EEB	Guggenheim BRIC ETF
EEFT	Euronet Worldwide Inc.
EEH	ELEMENTS SPECTRUM Lg Cap U.S. Sector ETN
EEHB	PowerShares S&P Emerg Mkts Hi Beta ETF
EEI	Ecology & Environment
EELV	PowerShares S&P Em Mkts Low Volatil ETF
EEM	iShares MSCI Emerging Markets
EEMA	iShares MSCI Emerging Markets Asia
EEME	iShares MSCI Emerging Markets EMEA
EEML	iShares MSCI Emerging Markets Latin Amer
EEP	Enbridge Energy Partners
EEQ	Enbridge Energy Management LLC
EES	WisdomTree SmallCap Earnings
EET	ProShares Ultra MSCI Emerging Markets
EEV	ProShares UltraShort MSCI Emerging Mkts
EFA	iShares MSCI EAFE
EFC	Ellington Financial LLC
EFG	iShares MSCI EAFE Growth
EFII	Electronics for Imaging
EFNL	iShares MSCI Finland Capped
EFO	ProShares Ultra MSCI EAFE
EFOI	Energy Focus
EFR	Eaton Vance Senior Floating Rate Trust
EFSC	Enterprise Financial Services Corp.
EFT	Eaton Vance Floating-Rate Income Trust
EFU	ProShares UltraShort MSCI EAFE
EFUT	e-Future Information Technology Inc.
EFV	iShares MSCI EAFE Value
EFX	Equifax Inc.
EFZ	ProShares Short MSCI EAFE
EGAN	eGain Corporation
EGAS	Gas Natural Inc.
EGBN	Eagle Bancorp
EGF	BlackRock Enhanced Government Fund
EGHT	8x8 Inc.
EGI	Entree Gold Inc.
EGL	Engility Holdings
EGLE	Eagle Bulk Shipping
EGLT	Egalet Corporation
EGN	Energen Corp.
EGO	Eldorado Gold Corp.
EGOV	NIC Inc.
EGP	EastGroup Properties Inc.
EGPT	Market Vectors Egypt ETF
EGRW	iShares MSCI Emerging Markets Growth
EGRX	Eagle Pharmaceuticals Inc.
EGT	Entertainment Gaming Asia Inc.
EGY	Vaalco Energy Inc.
EHI	Western Asset Global High Income Fund Inc.
EHTH	eHealth
EIA	Eaton Vance California Municipal Bond Fund II
EIDO	iShares MSCI Indonesia
EIG	Employers Holdings
EIGI	Endurance International Group Holdings
EIM	Eaton Vance Municipal Bond Fund
EIO	Eaton Vance Ohio Municipal Bond
EIP	Eaton Vance Pennsylvania Municipal Bond Fund
EIRL	iShares MSCI Ireland Capped
EIS	iShares MSCI Israel Capped
EIV	Eaton Vance Municipal Bond Fund
EIX	Edison International
EJ	E-House
EL	Estee Lauder Companies Inc.
ELD	WisdomTree Emerging Markets Local Debt
ELGX	Endologix Inc.
ELLI	Ellie Mae
ELLO	Ellomay Capital Ltd.
ELMD	Electromed
ELNK	EarthLink Holdings Corp.
ELON	Echelon Corporation
ELOS	Syneron Medical Ltd.
ELP	Companhia Paranaense de Energia
ELRC	Electro Rent Corporation
ELS	Equity LifeStyle Properties
ELSE	Electro-Sensors Inc.
ELTK	Eltek Ltd.
ELX	Emulex Corporation
ELY	Callaway Golf Co.
EMAG	Market Vectors EM Aggregate Bd ETF
EMAN	eMagin Corp.
EMB	iShares JPMorgan USD Emerg Markets Bond
EMC	EMC Corporation
EMCB	WisdomTree Emerging Markets Corporate Bd
EMCD	SPDR BofA ML EM Corp Bd ETF
EMCF	Emclaire Financial Corp.
EMCI	EMC Insurance Group Inc.
EMD	Western Asset Emerging Markets 
EMDD	EGShares Emerg Mkts Domestic Demand ETF
EMDI	iShares MSCI Emerging Mkts Cnsmr Discret
EME	EMCOR Group Inc.
EMES	Emerge Energy Services LP
EMEY	iShares MSCI Emerging Mkts Energy Capped
EMF	Templeton Emerging Markets Fund
EMFM	Global X Next Emerging & Frontier ETF
EMFN	iShares MSCI Emerging Markets Financials
EMHD	EGShares EM Dividend High Income ETF
EMHY	iShares Emerging Markets High Yield Bond
EMI	Eaton Vance Michigan Municipal 
EMIF	iShares Emerging Markets Infrastructure
EMITF	Elbit Imaging Ltd.
EMJ	Eaton Vance New Jersey Municipa
EMKR	EMCORE Corporation
EML	The Eastern Company
EMLC	Market Vectors EM Local Currency Bd ETF
EMLP	First Trust North American Energy Infras
EMMS	Emmis Communications Corp.
EMMT	iShares MSCI Emerging Markets Materials
EMN	Eastman Chemical Co.
EMR	Emerson Electric Co.
EMSA	iPath Short Enhanced MSCI Emerg Mkts ETN
EMSH	ProShares Short Term USD Emerg Mkts Bd
EMXX	Eurasian Minerals Inc.
ENB	Enbridge Inc.
ENBL	Enable Midstream Partners
END	Endeavour International Corporation
ENDP	Endo International plc
ENFR	ALPS Alerian Energy Infrastructure ETF
ENG	ENGlobal Corp.
ENGN	iShares Industrials Bond
ENH	Endurance Specialty Holdings Ltd.
ENI	Enersis S.A.
ENL	Reed Elsevier NV
ENLC	EnLink Midstream
ENLK	EnLink Midstream Partners
ENOC	EnerNOC
ENPH	Enphase Energy
ENR	Energizer Holdings Inc.
ENRJ	EnerJex Resources
ENS	EnerSys
ENSG	The Ensign Group
ENSV	Enservco Corporation
ENT	Global Eagle Entertainment Inc.
ENTA	Enanta Pharmaceuticals
ENTG	Entegris
ENTR	Entropic Communications
ENV	Envestnet
ENVE	Enventis Corporation
ENVI	Envivio
ENX	Eaton Vance New York Municipal 
ENY	Guggenheim Canadian Energy Income ETF
ENZ	Enzo Biochem Inc.
ENZL	iShares MSCI New Zealand Capped
ENZN	Enzon Pharmaceuticals Inc.
ENZY	Enzymotec Ltd.
EOC	Empresa Nacional de Electricidad S.A.
EOD	Wells Fargo Advantage Global Di
EOG	EOG Resources
EOI	Eaton Vance Enhanced Equity Income Fund
EOPN	E2open
EOS	Eaton Vance Enhanced Equity Income Fund II
EOX	Emerald Oil
EPAM	EPAM Systems
EPAX	Ambassadors Group Inc.
EPAY	Bottomline Technologies
EPB	El Paso Pipeline Partners
EPD	Enterprise Products Partners L.P.
EPE	EP Energy Corporation
EPHE	iShares MSCI Philippines
EPI	WisdomTree India Earnings
EPIQ	Epiq Systems
EPM	Evolution Petroleum Corp.
EPOL	iShares MSCI Poland Capped
EPP	iShares MSCI Pacific ex-Japan
EPR	EPR Properties
EPRO	AdvisorShares EquityPro ETF
EPS	WisdomTree Earnings 500
EPU	iShares MSCI All Peru Capped
EPV	ProShares UltraShort FTSE Europe
EPZM	Epizyme
EQIX	Equinix
EQL	ALPS Equal Sector Weight ETF
EQLT	ALPS Workplace Equality ETF
EQM	EQT Midstream Partners
EQR	Equity Residential
EQS	Equus Total Return
EQT	EQT Corporation
EQY	Equity One Inc.
ERA	Era Group Inc.
ERB	ERBA Diagnostics
ERC	Wells Fargo Advantage Multi-Sec
ERF	Enerplus Corporation
ERH	Wells Fargo Advantage Utilities
ERIC	Ericsson
ERIE	Erie Indemnity Company
ERII	Energy Recovery
ERJ	Embraer SA
ERO	iPath EUR/USD Exchange Rate ETN
EROC	Eagle Rock Energy Partners
EROS	Eros International Plc
ERS	Empire Resources Inc.
ERUS	iShares MSCI Russia Capped Index
ERX	Direxion Daily Energy Bull 3X Shares
ERY	Direxion Daily Energy Bear 3X Shares
ESBA	Empire State Realty OP
ESBF	ESB Financial Corp.
ESBK	Elmira Savings Bank
ESCA	Escalade Inc.
ESCR	Escalera Resources Co.
ESD	Legg Mason Partners Income Trust - Western Asset Emerging Markets Debt Portfolio
ESE	ESCO Technologies Inc.
ESEA	Euroseas
ESGR	Enstar Group Limited
ESI	ITT Educational Services Inc.
ESIO	Electro Scientific Industries Inc.
ESL	Esterline Technologies Corp.
ESLT	Elbit Systems Ltd.
ESMC	Escalon Medical Corp.
ESNT	Essent Group Ltd.
ESP	Espey Mfg. & Electronics Corp.
ESPR	Esperion Therapeutics
ESR	iShares MSCI Emerg Mkts Eastern Eur
ESRT	Empire State Realty Trust
ESRX	Express Scripts Holding Company
ESS	Essex Property Trust Inc.
ESSA	ESSA Bancorp
ESSX	Essex Rental Corp.
ESTE	Earthstone Energy
ESV	Ensco plc
ESXB	Community Bankers Trust Corporation
ESYS	Elecsys Corporation
ETAK	Elephant Talk Communications Corp.
ETB	Euro Stoxx 50 THEAM Easy ETF D
ETE	Energy Transfer Equity
ETF	Aberdeen Emerging Markets Telecommunications Fund
ETFC	E*TRADE Financial Corporation
ETG	Eaton Vance Tax Advantaged Global Dividend Income Fund
ETH	Ethan Allen Interiors Inc.
ETJ	Eaton Vance Risk-Managed Divers
ETM	Entercom Communications Corp.
ETN	Eaton Corporation plc
ETO	Eaton Vance Tax-Advantaged Global Dividend Opportunities Fund
ETP	Energy Transfer Partners
ETR	Entergy Corporation
ETRM	EnteroMedics Inc.
ETV	Eaton Vance Tax-Managed Buy-Write Opportunities Fund
ETW	Eaton Vance Tax-Managed Global Buy-Write Opportunities Fund
ETY	Eaton Vance Tax-Managed Diversified Equity Income Fund
EU	WisdomTree Euro Debt
EUDG	WisdomTree Europe Dividend Growth
EUFN	iShares MSCI Europe Financials
EUM	ProShares Short MSCI Emerging Markets
EUMV	iShares MSCI Europe Minimum Volatility
EUO	ProShares UltraShort Euro
EURL	Direxion Daily FTSE Europe Bull 3X Shrs
EURZ	Direxion Daily FTSE Europe Bear 3X Shrs
EUSA	iShares MSCI USA
EV	Eaton Vance Corp.
EVAL	iShares MSCI Emerging Markets Value
EVAR	Lombard Medical
EVBN	Evans Bancorp Inc.
EVBS	Eastern Virginia Bankshares Inc.
EVC	Entravision Communications Corporation
EVDY	Everyday Health
EVEP	EV Energy Partners LP
EVER	EverBank Financial Corp.
EVF	Eaton Vance Senior Income Trust
EVG	Eaton Vance Short Duration Diversified Income Fund
EVGN	Evogene Ltd.
EVHC	Envision Healthcare Holdings
EVI	EnviroStar
EVJ	Eaton Vance New Jersey Municipal Income Trust
EVK	Ever-Glory International Group
EVM	Eaton Vance California Municipal Bond Fund
EVN	Eaton Vance Municipal Income Trust
EVO	Eaton Vance Ohio Municipal Income Trust
EVOK	Evoke Pharma
EVOL	Evolving Systems Inc.
EVP	Eaton Vance Pennsylvania Municipal Income Trust
EVR	Evercore Partners Inc.
EVRY	EveryWare Global
EVT	Eaton Vance Tax-Advantaged Dividend Income Fund
EVTC	EVERTEC
EVV	Eaton Vance Limited Duration Income Fund
EVX	Market Vectors Environmental Svcs ETF
EVY	Eaton Vance New York Municipal Income Trust
EW	Edwards Lifesciences Corp.
EWA	iShares MSCI Australia
EWAS	iShares MSCI Australia Small-Cap
EWBC	East West Bancorp
EWC	iShares MSCI Canada
EWCS	iShares MSCI Canada Small-Cap
EWD	iShares MSCI Sweden
EWEM	Guggenheim MSCI Emerging Mkts Eq Wt ETF
EWG	iShares MSCI Germany
EWGS	iShares MSCI Germany Small-Cap
EWH	iShares MSCI Hong Kong
EWHS	iShares MSCI Hong Kong Small-Cap
EWI	iShares MSCI Italy Capped
EWJ	iShares MSCI Japan
EWK	iShares MSCI Belgium Capped
EWL	iShares MSCI Switzerland Capped Index
EWM	iShares MSCI Malaysia
EWN	iShares MSCI Netherlands
EWO	iShares MSCI Austria Capped
EWP	iShares MSCI Spain Capped
EWQ	iShares MSCI France
EWRI	Guggenheim Russell 1000 Equal Wt ETF
EWRM	Guggenheim Russell MidCap Equal Wt ETF
EWRS	Guggenheim Russell 2000 Equal Wt ETF
EWS	iShares MSCI Singapore
EWSS	iShares MSCI Singapore Small-Cap
EWT	iShares MSCI Taiwan
EWU	iShares MSCI United Kingdom
EWUS	iShares MSCI United Kingdom Small-Cap
EWV	ProShares UltraShort MSCI Japan
EWW	iShares MSCI Mexico Capped
EWX	SPDR S&P Emerging Markets Small Cap
EWY	iShares MSCI South Korea Capped
EWZ	iShares MSCI Brazil Capped
EWZS	iShares MSCI Brazil Small-Cap
EXA	Exa Corporation
EXAC	Exactech Inc.
EXAM	ExamWorks Group
EXAR	Exar Corp.
EXAS	Exact Sciences Corporation
EXC	Exelon Corporation
EXE	Crexendo
EXEL	Exelixis
EXFO	EXFO Inc
EXG	Eaton Vance Tax-Managed Global 
EXH	Exterran Holdings
EXI	iShares Global Industrials
EXK	Endeavour Silver Corp.
EXL	Excel Trust
EXLP	Exterran Partners
EXLS	Exlservice Holdings
EXP	Eagle Materials Inc.
EXPD	Expeditors International of Washington Inc.
EXPE	Expedia Inc.
EXPO	Exponent Inc.
EXPR	Express Inc.
EXR	Extra Space Storage Inc.
EXT	WisdomTree Total Earnings
EXTR	Extreme Networks Inc.
EXXI	Energy XXI
EZA	iShares MSCI South Africa
EZCH	EZchip Semiconductor Ltd.
EZJ	ProShares Ultra MSCI Japan
EZM	WisdomTree MidCap Earnings
EZPW	EZCORP
EZU	iShares MSCI EMU Index
EZY	WisdomTree LargeCap Value
F	Ford Motor Co.
FAB	First Trust Multi Cap Value AlphaDEX
FAC	First Acceptance Corp.
FAD	First Trust Multi Cap Growth AlphaDEX
FAF	First American Financial Corporation
FALC	Falconstor Software Inc.
FAM	First Trust/Aberdeen Global Opportunity Income Fund
FAN	First Trust ISE Global Wind Energy
FANG	Diamondback Energy
FARM	Farmer Brothers Co.
FARO	FARO Technologies Inc.
FAS	Direxion Daily Financial Bull 3X Shares
FAST	Fastenal Company
FATE	Fate Therapeutics
FAUS	First Trust Australia AlphaDEX
FAV	First Trust Dividend and Income
FAX	Aberdeen Asia-Pacific Income Fund Inc.
FAZ	Direxion Daily Financial Bear 3X Shares
FB	Facebook
FBC	Flagstar Bancorp Inc.
FBG	UBS Fisher Enhanced Big Cap Growth ETN
FBHS	Fortune Brands Home & Security
FBIZ	First Business Financial Services
FBMS	First Bancshares Inc.
FBNC	First Bancorp
FBNK	First Connecticut Bancorp
FBP	First Bancorp
FBR	Fibria Celulose SA
FBRC	FBR & Co.
FBSS	Fauquier Bankshares Inc.
FBT	First Trust NYSE Arca Biotech Index
FC	Franklin Covey Co.
FCAN	First Trust Canada AlphaDEX
FCAP	First Capital Inc.
FCBC	First Community Bancshares
FCCO	First Community Corporation
FCCY	1st Constitution Bancorp
FCE-A	Forest City Enterprises Inc.
FCEL	FuelCell Energy Inc.
FCF	First Commonwealth Financial Corp.
FCFS	First Cash Financial Services Inc.
FCG	First Trust ISE-Revere Natural Gas Idx
FCH	FelCor Lodging Trust Incorporated
FCHI	iShares FTSE China
FCLF	First Clover Leaf Financial Corp.
FCN	FTI Consulting
FCNCA	First Citizens Bancshares Inc.
FCO	Aberdeen Global Income Fund Inc.
FCOM	Fidelity MSCI Telecom Svcs ETF
FCS	Fairchild Semiconductor International Inc.
FCSC	Fibrocell Science
FCT	First Trust Senior Floating Rat
FCTY	1st Century Bancshares
FCVA	First Capital Bancorp
FCX	Freeport-McMoRan Inc.
FCZA	First Citizens Banc Corp.
FDD	First Trust STOXX Euro Select Div Idx
FDEF	First Defiance Financial Corp.
FDI	Fort Dearborn Income Securities Inc.
FDIS	Fidelity MSCI Consumer Discretionary ETF
FDL	First Trust Morningstar Div Leaders Idx
FDM	First Trust Dow Jones Select MicroCp Idx
FDML	Federal-Mogul Holdings Corporation
FDN	First Trust Dow Jones Internet Index
FDO	Family Dollar Stores Inc.
FDP	Fresh Del Monte Produce Inc.
FDS	FactSet Research Systems Inc.
FDT	First Trust Dev Markets Ex-US AlphaDEX
FDTS	First Trust Dev Mkts ex-US SC AlphaDEX
FDUS	Fidus Investment Corporation
FDV	First Trust Strategic Value Index
FDX	FedEx Corporation
FE	FirstEnergy Corp.
FEFN	iShares MSCI Far East Financials
FEIC	FEI Company
FEIM	Frequency Electronics Inc.
FELE	Franklin Electric Co.
FELP	Foresight Energy LP
FEMS	First Trust Emerging Markets SC AlphaDEX
FEN	Energy Income & Growth Fund
FENG	Phoenix New Media Limited
FENY	Fidelity MSCI Energy Index ETF
FEO	First Trust/Aberdeen Emerging Opportunity Fund
FEP	First Trust Europe AlphaDEX
FES	Forbes Energy Services Ltd.
FET	Forum Energy Technologies
FEU	SPDR STOXX Europe 50
FEX	First Trust Large Cap Core AlphaDEX
FEYE	FireEye
FEZ	SPDR EURO STOXX 50
FF	FutureFuel Corp.
FFA	First Trust Enhanced Equity Income Fund
FFBC	First Financial Bancorp.
FFC	Flaherty & Crumrine/Claymore Preferred Securities Income Fund Inc.
FFCO	FedFirst Financial Corp.
FFG	FBL Financial Group Inc.
FFHL	Fuwei Films
FFIC	Flushing Financial Corp.
FFIN	First Financial Bankshares Inc.
FFIV	F5 Networks
FFKT	Farmers Capital Bank Corporation
FFKY	First Financial Service Corp.
FFNM	First Federal of Northern Michigan Bancorp
FFNW	First Financial Northwest
FFR	First Trust FTSE EN Dev Mkts Rel Est Idx
FGB	First Trust Specialty Finance a
FGD	First Trust DJ Global Select Dividend
FGM	First Trust Germany AlphaDEX
FGP	Ferrellgas Partners LP
FHCO	The Female Health Company
FHK	First Trust Hong Kong AlphaDEX
FHLC	Fidelity MSCI Health Care Index ETF
FHN	First Horizon National Corporation
FHY	First Trust Strategic High Inco
FI	Frank's International N.V.
FIBK	First Interstate Bancsystem Inc.
FICO	Fair Isaac Corporation
FIDU	Fidelity MSCI Industrials Index ETF
FIEU	Credit Suisse FI Enhanced Europe 50 ETN
FIG	Fortress Investment Group LLC
FII	Federated Investors
FILL	iShares MSCI Global Energy Producers
FINF	ProShares Short 30 Year TIPS/TSY Spread
FINL	Finish Line Inc.
FIS	Fidelity National Information Services
FISH	Marlin Midstream Partners
FISI	Financial Institutions Inc.
FISV	Fiserv
FITB	Fifth Third Bancorp
FIVE	Five Below
FIVN	Five9
FIVZ	PIMCO 3-7 Year U.S. Treasury ETF
FIW	First Trust ISE Water Idx
FIX	Comfort Systems USA Inc.
FIZZ	National Beverage Corp.
FKU	First Trust United Kingdom AlphaDEX
FL	Foot Locker
FLAG	Forensic Accounting ETF
FLAT	iPath US Treasury Flattener ETN
FLC	Flaherty & Crumrine/Claymore Total Return Fund
FLDM	Fluidigm Corporation
FLEX	Flextronics International Ltd.
FLIC	The First of Long Island Corporation
FLIR	FLIR Systems
FLL	Full House Resorts Inc.
FLM	First Trust ISE Glbl Engnrg & Const Idx
FLML	Flamel Technologies SA
FLO	Flowers Foods
FLOT	iShares Floating Rate Bond
FLR	Fluor Corporation
FLRN	SPDR Barclays Cap Inv Gr Floating Rt ETF
FLS	Flowserve Corp.
FLT	FleetCor Technologies
FLTR	Market Vectors Investment Grd Fl Rt ETF
FLTX	Fleetmatics Group PLC
FLWS	1-800-Flowers.com Inc.
FLXN	Flexion Therapeutics
FLXS	Flexsteel Industries Inc.
FLY	FLY Leasing Limited
FM	iShares MSCI Frontier 100
FMAT	Fidelity MSCI Materials Index ETF
FMBH	First Mid-Illinois Bancshares Inc.
FMBI	First Midwest Bancorp Inc.
FMC	FMC Corp.
FMD	The First Marblehead Corporation
FMER	FirstMerit Corporation
FMF	First Trust Morningstar Futs Strat
FMI	Foundation Medicine
FMK	First Trust Mega Cap Alphadex
FMN	Federated Premier Municipal Inc
FMNB	Farmers National Banc Corp.
FMO	Fiduciary/Claymore MLP Opportunity Fund
FMS	Fresenius Medical Care AG & Co. KGAA
FMX	Fomento Econ
FMY	First Trust Motgage Income Fund
FN	Fabrinet
FNB	F.N.B. Corporation
FNCL	Fidelity MSCI Financials Index ETF
FNDA	Schwab Fundamental US Small Company ETF
FNDB	Schwab Fundamental US Broad Market ETF
FNDC	Schwab Fundamental Intl Sm Co ETF
FNDE	Schwab Fundamental Emerg Mkts Lg Co ETF
FNDF	Schwab Fundamental Intl Lg Co ETF
FNDX	Schwab Fundamental US Large Company ETF
FNF	Fidelity National Financial
FNFG	First Niagara Financial Group Inc.
FNGN	Financial Engines
FNHC	Federated National Holding Company
FNI	First Trust ISE Chindia Idx
FNIO	iShares Indl/Office Rel Est Capped
FNJN	Finjan Holdings
FNLC	The First Bancorp
FNRG	ForceField Energy Inc.
FNSR	Finisar Corp.
FNV	Franco-Nevada Corporation
FNX	First Trust Mid Cap Core AlphaDEX
FOE	Ferro Corporation
FOF	Cohen & Steers Closed-End Oppor
FOIL	iPath Pure Beta Aluminum ETN
FOLD	Amicus Therapeutics
FONE	First Trust NASDAQ CEA Smartphone Idx
FONR	Fonar Corp.
FOR	Forestar Group Inc.
FORD	Forward Industries Inc.
FORM	FormFactor Inc.
FORR	Forrester Research Inc.
FORTY	Formula Systems
FORX	PIMCO Foreign Currency Strategy ETF
FOSL	Fossil Group
FOXA	Twenty-First Century Fox
FOXF	Fox Factory Holding Corp
FPE	First Trust Preferred Sec & Inc ETF
FPI	Farmland Partners Inc.
FPO	First Potomac Realty Trust
FPP	Fieldpoint Petroleum Corp.
FPRX	Five Prime Therapeutics
FPT	Federated Premier Intermediate 
FPX	First Trust US IPO Index
FR	First Industrial Realty Trust Inc.
FRA	Blackrock Floating Rate Income 
FRAK	Market Vectors Unconvnt Oil & Gas ETF
FRAN	Francesca's Holdings Corporation
FRBA	First Bank
FRBK	Republic First Bancorp Inc.
FRC	First Republic Bank
FRD	Friedman Industries
FRED	Fred's
FREE	FreeSeas Inc.
FRF	Fortegra Financial Corporation
FRGI	Fiesta Restaurant Group
FRI	First Trust S&P REIT Idx
FRM	Furmanite Corporation
FRME	First Merchants Corporation
FRN	Guggenheim Frontier Markets ETF
FRNK	Franklin Financial Corporation
FRO	Frontline Ltd.
FRP	Fairpoint Communications
FRS	Frisch's Restaurants
FRSH	Papa Murphy's Holdings
FRT	Federal Realty Investment Trust
FSBK	First South Bancorp Inc.
FSBW	FS Bancorp
FSC	Fifth Street Finance Corp.
FSFG	First Savings Financial Group
FSGI	First Security Group
FSI	Flexible Solutions International Inc.
FSL	Freescale Semiconductor
FSLR	First Solar
FSM	Fortuna Silver Mines Inc.
FSNN	Fusion Telecommunications International
FSP	Franklin Street Properties Corp.
FSRV	FirstService Corporation
FSS	Federal Signal Corp.
FST	Forest Oil Corporation
FSTA	Fidelity MSCI Consumer Staples Index ETF
FSTR	LB Foster Co.
FSYS	Fuel Systems Solutions
FSZ	First Trust Switzerland AlphaDEX
FT	Franklin Universal Trust
FTA	First Trust Large Cap Value AlphaDEX
FTC	First Trust Large Cap Gr Opp AlphaDEX
FTD	FTD Companies
FTEC	Fidelity MSCI Information Technology ETF
FTEK	Fuel-Tech
FTF	Franklin Templeton Limited Duration Income Trust
FTHI	First Trust High Income ETF
FTI	FMC Technologies
FTK	Flotek Industries Inc.
FTLB	First Trust Low Beta Income ETF
FTNT	Fortinet Inc.
FTR	Frontier Communications Corporation
FTSD	Franklin Short Duration US Govt ETF
FTW	First Trust Taiwan AlphaDEX
FTY	iShares Real Estate 50
FU	FAB Universal Corporation
FUBC	1st United Bancorp
FUD	UBS E-TRACS CMCI Food TR ETN
FUE	ELEMENTS MLCX Biofuels Index TR ETN
FUEL	Rocket Fuel Inc.
FUL	HB Fuller Co.
FULL	Full Circle Capital Corporation
FULT	Fulton Financial Corporation
FUN	Cedar Fair
FUNC	First United Corporation
FUND	Royce Focus Trust
FUR	Winthrop Realty Trust
FUTY	Fidelity MSCI Utilities Index ETF
FV	First Trust Dorsey Wright Focus 5 ETF
FVD	First Trust Value Line Dividend Index
FVE	Five Star Quality Care Inc.
FVI	First Trust Value Line Equity Allc Index
FVL	First Trust Value Line 100 ETF
FWDB	AdvisorShares Madrona Global Bond ETF
FWDD	AdvisorShares Madrona Domestic ETF
FWDI	AdvisorShares Madrona International ETF
FWLT	Foster Wheeler AG
FWM	Fairway Group Holdings Corp.
FWRD	Forward Air Corp.
FWV	First West Virginia Bancorp Inc.
FXA	CurrencyShares Australian Dollar ETF
FXB	CurrencyShares British Pound Ster ETF
FXC	CurrencyShares Canadian Dollar ETF
FXCB	Fox Chase Bancorp
FXCH	CurrencyShares Chinese Renminbi ETF
FXCM	FXCM Inc.
FXD	First Trust Consumer Disc AlphaDEX
FXE	CurrencyShares Euro ETF
FXEN	FX Energy Inc.
FXF	CurrencyShares Swiss Franc ETF
FXG	First Trust Consumer Staples AlphaDEX
FXH	First Trust Health Care AlphaDEX
FXI	iShares China Large-Cap
FXL	First Trust Technology AlphaDEX
FXN	First Trust Energy AlphaDEX
FXO	First Trust Financials AlphaDEX
FXP	ProShares UltraShort FTSE China 25
FXR	First Trust Indust/Producer Dur AlphaDEX
FXS	CurrencyShares Swedish Krona ETF
FXSG	CurrencyShares Singapore Dollar ETF
FXU	First Trust Utilities AlphaDEX
FXY	CurrencyShares Japanese Yen ETF
FXZ	First Trust Materials AlphaDEX
FYLD	Cambria Foreign Shareholder Yield ETF
FYX	First Trust Small Cap Core AlphaDEX
G	Genpact Limited
GAB	Gabelli Equity Trust
GABC	German American Bancorp Inc.
GAF	SPDR S&P Emerging Middle East & Africa
GAGA	Le Gaga Holdings Ltd
GAI	Global-Tech Advanced Innovations Inc.
GAIA	Gaiam Inc.
GAIN	Gladstone Investment Corporation
GAL	SPDR SSgA Global Allocation ETF
GALE	Galena Biopharma
GALT	Galectin Therapeutics
GAM	General American Investors Company
GAME	Shanda Games Limited
GARS	Garrison Capital Inc
GAS	AGL Resources Inc.
GASL	Direxion Daily Nat Gas Rltd Bull 3X Shrs
GASS	StealthGas
GASX	Direxion Daily Nat Gas Rltd Bear 3X Shrs
GAZ	iPath DJ-UBS Natural Gas TR Sub-Idx ETN
GB	Greatbatch
GBB	iPath GBP/USD Exchange Rate ETN
GBCI	Glacier Bancorp
GBDC	Golub Capital BDC
GBF	iShares Government/Credit Bond
GBL	GAMCO Investors
GBLI	Global Indemnity plc
GBNK	Guaranty Bancorp
GBR	New Concept Energy
GBX	The Greenbrier Companies
GCA	Global Cash Access Holdings
GCAP	GAIN Capital Holdings
GCBC	Greene County Bancorp
GCC	GreenHaven Continuous Commodity ETF
GCE	Claymore CEF GS Connect ETN
GCH	The Greater China Fund
GCI	Gannett Co.
GCO	Genesco Inc.
GCV	Gabelli Convertible & Income Securities Fund Inc.
GD	General Dynamics Corp.
GDEF	Global Defense & National Security Systems
GDF	Western Asset Global Partners Income Fund Inc.
GDL	GDL Fund
GDOT	Green Dot Corporation
GDP	Goodrich Petroleum Corp.
GDV	Gabelli Dividend & Income Trust
GDX	Market Vectors Gold Miners ETF
GDXJ	Market Vectors Junior Gold Miners ETF
GE	General Electric Company
GEF	Greif
GEL	Genesis Energy LP
GENC	Gencor Industries Inc.
GENE	Genetic Technologies Limited
GEO	The GEO Group
GEOS	Geospace Technologies Corporation
GERJ	Market Vectors Germany Small-Cap ETF
GERN	Geron Corporation
GES	Guess' Inc.
GEUR	AdvisorShares Gartman Gold/Euro ETF
GEVA	Synageva BioPharma Corp.
GEVO	Gevo
GEX	Market Vectors Global Alt Energy ETF
GF	New Germany Fund
GFA	Gafisa S.A.
GFED	Guaranty Federal Bancshares Inc.
GFF	Griffon Corporation
GFI	Gold Fields Ltd.
GFIG	GFI Group Inc.
GFN	General Finance Corporation
GFY	Western Asset Variable Rate Strategic Fund Inc.
GG	Goldcorp Inc.
GGAL	Grupo Financiero Galicia S.A.
GGB	Gerdau S.A.
GGBP	AdvisorShares Gartman Gold/Britsh Pd ETF
GGG	Graco Inc.
GGN	The Gabelli Global Gold
GGOV	ProShares German Sovereign/Sub-Sovereign
GGP	General Growth Properties
GGT	Gabelli Multi-Media Trust
GHC	Graham Holdings
GHDX	Genomic Health Inc.
GHI	Global High Income Fund
GHL	Greenhill & Co.
GHM	Graham Corporation
GHYG	iShares Global High Yield Corporate Bond
GIB	CGI Group
GIFI	Gulf Island Fabrication Inc.
GIG	GigOptix
GIGA	Giga-tronics Inc.
GIGM	GigaMedia Ltd.
GII	SPDR S&P Global Infrastructure
GIII	G-III Apparel Group
GIL	Gildan Activewear Inc.
GILD	Gilead Sciences Inc.
GILT	Gilat Satellite Networks Ltd.
GIM	Templeton Global Income Fund
GIMO	Gigamon Inc.
GIS	General Mills
GIVE	AdvisorShares Global Echo ETF
GK	G&K Services Inc.
GKNT	Geeknet
GLAD	Gladstone Capital Corporation
GLBS	Globus Maritime Limited
GLBZ	Glen Burnie Bancorp
GLCH	Gleacher & Company
GLD	SPDR Gold Shares
GLDC	Golden Enterprises Inc.
GLDD	Great Lakes Dredge & Dock Corporation
GLDE	AdvisorShares International Gold ETF
GLDI	Credit Suisse Gold Shrs Cov Call Exc ETN
GLDX	Global X Gold Explorers ETF
GLF	Gulfmark Offshore
GLL	ProShares UltraShort Gold
GLMD	Galmed Pharmaceuticals Ltd.
GLNG	Golar LNG Ltd.
GLOG	GasLog Ltd.
GLOP	GasLog Partners LP
GLOW	Glowpoint
GLP	Global Partners LP
GLPI	Gaming and Leisure Properties
GLPW	Global Power Equipment Group Inc.
GLQ	Clough Global Equity Fund
GLRE	Greenlight Capital Re
GLRI	Glori Energy
GLT	PH Glatfelter Co.
GLTR	ETFS Physical PM Basket Shares
GLU	The Gabelli Global Utility & Income Trust
GLUU	Glu Mobile
GLV	Clough Global Allocation Fund C
GLW	Corning Inc.
GM	General Motors Company
GMAN	Gordmans Stores
GMCR	Keurig Green Mountain
GME	GameStop Corp.
GMED	Globus Medical
GMF	SPDR S&P Emerging Asia Pacific
GMFS	SPDR S&P Small Cap Em Asia Pacific ETF
GMK	Gruma S.A.B. de CV
GML	SPDR S&P Emerging Latin America
GMLP	Golar LNG Partners LP
GMM	SPDR S&P Emerging Markets
GMMB	Columbia Intermediate Municipal Bond ETF
GMO	General Moly
GMT	GATX Corp.
GMTB	Columbia Core Bond ETF
GNAT	WisdomTree Global Natural Resources
GNC	GNC Holdings Inc.
GNCA	Genocea Biosciences
GNCMA	General Communication Inc.
GNE	Genie Energy Ltd.
GNI	Great Northern Iron Ore Properties
GNMA	iShares Core GNMA Bond
GNMK	GenMark Diagnostics
GNR	SPDR S&P Global Natural Resources
GNRC	Generac Holdings Inc.
GNTX	Gentex Corp.
GNVC	GenVec
GNW	Genworth Financial
GOF	Guggenheim Strategic Opportunit
GOGO	Gogo Inc.
GOL	GOL Linhas A
GOLD	Randgold Resources Limited
GOMO	Sungy Mobile Limited
GOOD	Gladstone Commercial Corp.
GOOG	Google Inc.
GOOGL	Google Inc.
GORO	Gold Resource Corp
GOV	Government Properties Income Trust
GOVT	iShares Core US Treasury Bond
GPC	Genuine Parts Company
GPI	Group 1 Automotive Inc.
GPIC	Gaming Partners International Corporation
GPK	Graphic Packaging Holding Company
GPL	Great Panther Silver Ltd
GPM	Guggenheim Enhanced Equity Income Fund
GPN	Global Payments Inc.
GPOR	Gulfport Energy Corp.
GPRC	Guanwei Recycling Corp.
GPRE	Green Plains Inc.
GPRK	GeoPark Limited
GPRO	GoPro
GPS	The Gap
GPT	Gramercy Property Trust Inc.
GPX	GP Strategies Corp.
GQRE	FlexShares Global Quality Real Estate
GRA	W.R. Grace & Co.
GRAM	Gra
GRC	Gorman-Rupp Co.
GREK	Global X FTSE Greece 20 ETF
GRES	IQ Global Resources ETF
GRF	Eagle Capital Growth Fund
GRH	GreenHunter Resources
GRI	Cohen & Steers Global Realty Majors ETF
GRID	First Trust NASDAQ Cln Edge Smrt Grd Inf
GRIF	Griffin Land & Nurseries Inc.
GRMN	Garmin Ltd.
GRN	iPath Global Carbon ETN
GRO	Agria Corporation
GROW	U.S. Global Investors
GRPN	Groupon
GRR	Asia Tigers Fund
GRT	Glimcher Realty Trust
GRU	ELEMENTS MLCX Grains Index TR ETN
GRUB	GrubHub Inc.
GRVY	Gravity Co.
GRWN	iPath Pure Beta Softs ETN
GS	The Goldman Sachs Group
GSAT	Globalstar Inc.
GSAX	ALPS/GS Mom Bldr AsExJPN Eq & US Trs ETF
GSB	GlobalSCAPE
GSBC	Great Southern Bancorp Inc.
GSC	GS Connect S&P GSCI Enh Commodity TR ETN
GSG	iShares S&P GSCI Commodity-Indexed Trust
GSGO	ALPS/GS Mom Bldr Gr Mkts Eq& US Trs ETF
GSH	Guangshen Railway Co. Ltd.
GSI	General Steel Holdings
GSIG	GSI Group Inc.
GSIT	GSI Technology Inc.
GSJK	Compressco Partners
GSK	GlaxoSmithKline plc
GSL	Global Ship Lease
GSM	Globe Specialty Metals
GSOL	Global Sources Ltd.
GSP	iPath S&P GSCI Total Return Index ETN
GSRA	ALPS/GS Risk-Adjusted Ret US Lrg Cap ETF
GSS	Golden Star Resources
GST	Gastar Exploration Inc.
GSV	Gold Standard Ventures Corp
GSVC	GSV Capital Corp.
GSY	Guggenheim Enhanced Short Dur ETF
GT	The Goodyear Tire & Rubber Company
GTAA	AdvisorShares Morg Crk Glbl Tacticl ETF
GTAT	GT Advanced Technologies Inc.
GTE	Gran Tierra Energy
GTI	GrafTech International Ltd.
GTIM	Good Times Restaurants Inc.
GTIP	iShares Global Inflation-Linked Bond
GTIV	Gentiva Health Services Inc.
GTLS	Chart Industries Inc.
GTN	Gray Television Inc.
GTN-A	Gray Television Inc.
GTS	Triple-S Management Corporation
GTT	GTT Communications
GTU	Central GoldTrust
GTWN	Georgetown Bancorp Inc.
GTXI	GTX Inc.
GTY	Getty Realty Corp.
GUID	Guidance Software
GULF	WisdomTree Middle East Dividend
GUNR	FlexShares Mstar Gbl Upstrm Nat Res ETF
GUR	SPDR S&P Emerging Europe
GURE	Gulf Resources
GURU	Global X Guru Index ETF
GUT	Gabelli Utility Trust
GV	Goldfield Corp.
GVA	Granite Construction Incorporated
GVI	iShares Intm Government/Credit Bond
GVP	GSE Systems Inc.
GVT	Columbia Select Large Cap Value ETF
GWL	SPDR S&P World ex-US
GWPH	GW Pharmaceuticals plc
GWR	Genesee & Wyoming Inc.
GWRE	Guidewire Software
GWW	W.W. Grainger
GWX	SPDR S&P International Small Cap
GXC	SPDR S&P China
GXF	Global X FTSE Nordic Region ETF
GXG	Global X MSCI Colombia ETF
GXP	Great Plains Energy Incorporated
GY	GenCorp Inc.
GYEN	AdvisorShares Gartman Gold/Yen ETF
GYLD	Arrow Dow Jones Global Yield ETF
GYRO	Gyrodyne Co. of America Inc.
GZT	Gazit-Globe
H	Hyatt Hotels Corporation
HA	Hawaiian Holdings Inc.
HAE	Haemonetics Corporation
HAFC	Hanmi Financial Corporation
HAIN	The Hain Celestial Group
HAL	Halliburton Company
HALL	Hallmark Financial Services Inc.
HALO	Halozyme Therapeutics
HAO	Guggenheim China Small Cap ETF
HAP	Market Vectors Natural Resources ETF
HAR	Harman International Industries
HAS	Hasbro Inc.
HASI	Hannon Armstrong Sustainable Infrastructure Capital
HAV	Helios Advantage Income Fund
HAWK	Blackhawk Network Holdings
HAYN	Haynes International
HBAN	Huntington Bancshares Incorporated
HBCP	Home Bancorp
HBHC	Hancock Holding Company
HBI	Hanesbrands Inc.
HBIO	Harvard Bioscience Inc.
HBK	Hamilton Bancorp
HBM	HudBay Minerals
HBMD	Howard Bancorp Inc.
HBNC	Horizon Bancorp
HBNK	Hampden Bancorp
HBOS	Heritage Financial Group
HBP	Huttig Building Products Inc.
HCA	HCA Holdings
HCAC	Hennessy Capital Acquisition Corp.
HCAP	Harvest Capital Credit Corporation
HCBK	Hudson City Bancorp
HCC	HCC Insurance Holdings Inc.
HCCI	Heritage-Crystal Clean
HCI	HCI Group
HCKT	The Hackett Group
HCLP	Hi-Crush Partners LP
HCN	Health Care REIT
HCOM	Hawaiian Telcom Holdco
HCP	HCP
HCSG	Healthcare Services Group Inc.
HCT	American Realty Capital Healthcare Trust
HD	The Home Depot
HDB	HDFC Bank Ltd.
HDG	ProShares Hedge Replication
HDGE	AdvisorShares Ranger Equity Bear ETF
HDGI	AdvisorShares Athena Intl Bear ETF
HDNG	Hardinge Inc.
HDS	HD Supply Holdings
HDSN	Hudson Technologies Inc.
HDY	Hyperdynamics Corporation
HE	Hawaiian Electric Industries Inc.
HEAR	Turtle Beach Corporation
HEB	Hemispherx Biopharma
HEDJ	WisdomTree Europe Hedged Equity
HEES	H&E Equipment Services Inc.
HEFA	iShares Currency Hedged MSCI EAFE
HEI	HEICO Corporation
HEI-A	HEICO Corporation
HELE	Helen of Troy Limited
HELI	CHC Group Ltd.
HEOP	Heritage Oaks Bancorp
HEP	Holly Energy Partners L.P
HERO	Hercules Offshore
HES	Hess Corporation
HEVY	iPath Pure Beta Industrial Metals ETN
HEWG	iShares Currency Hedged MSCI Germany
HEWJ	iShares Currency Hedged MSCI Japan
HF	HFF
HFBC	HopFed Bancorp Inc.
HFBL	Home Federal Bancorp
HFC	HollyFrontier Corporation
HFFC	HF Financial Corp.
HFIN	Horizons S&P Fincl Sel Sect Cov Call ETF
HFWA	Heritage Financial Corp.
HGG	hhgregg
HGI	Guggenheim Intl Multi-Asset Inc ETF
HGR	Hanger
HGSH	China HGS Real Estate Inc.
HGT	Hugoton Royalty Trust
HH	Hooper Holmes Inc.
HHC	The Howard Hughes Corporation
HHH	Internet HOLDRS
HHS	Harte-Hanks Inc.
HHY	Brookfield High Income Fund Inc
HI	Hillenbrand
HIBB	Hibbett Sports
HIFS	Hingham Institution for Savings
HIG	The Hartford Financial Services Group
HIH	Helios High Income Fund Inc New
HIHO	Highway Holdings Limited
HII	Huntington Ingalls Industries
HIIQ	Health Insurance Innovations
HIL	Hill International
HILL	Dot Hill Systems Corp.
HILO	EGShares Low Volatility EM Dividend ETF
HIMX	Himax Technologies
HIO	Western Asset High Income Opportunity Fund Inc.
HIVE	Aerohive Networks
HIW	Highwoods Properties Inc.
HIX	Western Asset High Income Fund II Inc.
HK	Halcon Resources Corp.
HKOR	Horizons Korea KOSPI 200 ETF
HL	Hecla Mining Co.
HLF	Herbalife Ltd.
HLIT	Harmonic Inc.
HLS	HEALTHSOUTH Corp.
HLSS	Home Loan Servicing Solutions
HLT	Hilton Worldwide Holdings Inc.
HLX	Helix Energy Solutions Group
HMC	Honda Motor Co.
HME	Home Properties Inc.
HMG	HMG/Courtland Properties Inc.
HMH	Helios Multi-Sector High Income
HMHC	Houghton Mifflin Harcourt Company
HMIN	Home Inns & Hotels Management Inc.
HMN	Horace Mann Educators Corp.
HMNF	HMN Financial Inc.
HMNY	Helios and Matheson Analytics Inc.
HMPR	Hampton Roads Bankshares Inc.
HMST	HomeStreet
HMSY	HMS Holdings Corp.
HMTV	Hemisphere Media Group
HMY	Harmony Gold Mining Company Limited
HNH	Handy & Harman Ltd.
HNI	HNI Corp.
HNNA	Hennessy Advisors
HNP	Huaneng Power International
HNR	Harvest Natural Resources Inc.
HNRG	Hallador Energy Company
HNSN	Hansen Medical
HNT	Health Net
HOFT	Hooker Furniture Corp.
HOG	Harley-Davidson
HOLD	AdvisorShares Sage Core Reserves ETF
HOLI	HollySys Automation Technologies
HOLX	Hologic Inc.
HOMB	Home Bancshares
HON	Honeywell International Inc.
HOS	Hornbeck Offshore Services
HOT	Starwood Hotels & Resorts Worldwide Inc.
HOTR	Chanticleer Holdings
HOV	Hovnanian Enterprises Inc.
HP	Helmerich & Payne
HPF	John Hancock Preferred Income Fund II
HPI	John Hancock Preferred Income Fund
HPJ	Highpower International
HPP	Hudson Pacific Properties
HPQ	Hewlett-Packard Company
HPS	John Hancock Preferred Income Fund III
HPT	Hospitality Properties Trust
HPTX	Hyperion Therapeutics
HPY	Heartland Payment Systems
HQH	H&Q Healthcare Investors
HQL	H&Q Life Sciences Investors
HR	Healthcare Realty Trust Incorporated
HRB	H&R Block
HRC	Hill-Rom Holdings
HRG	Harbinger Group Inc.
HRL	Hormel Foods Corporation
HRS	Harris Corporation
HRT	Arrhythmia Research Technology Inc.
HRTG	Heritage Insurance Holdings
HRTX	Heron Therapeutics
HRZN	Horizon Technology Finance Corporation
HSA	Helios Strategic Income Fund
HSBC	HSBC Holdings plc
HSC	Harsco Corporation
HSH	The Hillshire Brands Company
HSIC	Henry Schein
HSII	Heidrick & Struggles International Inc.
HSKA	Heska Corporation
HSNI	HSN
HSOL	Hanwha SolarOne Co.
HSON	Hudson Global
HSP	Hospira Inc.
HSPX	Horizons S&P 500 Covered Call ETF
HST	Host Hotels & Resorts
HSTM	Healthstream Inc.
HSY	The Hershey Company
HT	Hersha Hospitality Trust
HTA	Healthcare Trust of America
HTBI	HomeTrust Bancshares
HTBK	Heritage Commerce Corp.
HTBX	Heat Biologics
HTCH	Hutchinson Technology Inc.
HTD	John Hancock Tax Advantaged Dividend Income Fund
HTGC	Hercules Technology Growth Capital
HTH	Hilltop Holdings Inc.
HTHT	China Lodging Group
HTLD	Heartland Express
HTLF	Heartland Financial USA
HTM	U.S. Geothermal Inc.
HTR	Helios Total Return Fund
HTS	Hatteras Financial Corp
HTWO	HF2 Financial Management Inc.
HTWR	Heartware International Inc.
HTY	John Hancock Tax-Advantaged Glo
HTZ	Hertz Global Holdings
HUB-B	Hubbell Inc.
HUBG	Hub Group Inc.
HUM	Humana Inc.
HUN	Huntsman Corporation
HURC	Hurco Companies Inc.
HURN	Huron Consulting Group Inc.
HUSA	Houston American Energy Corp.
HUSE	Huntington US Equity Rotation Strat ETF
HVB	Hudson Valley Holding Corp.
HVPW	ALPS US Equity High Volatility Put Write
HVT	Haverty Furniture Companies Inc.
HW	Headwaters Incorporated
HWAY	Healthways Inc.
HWBK	Hawthorn Bancshares
HWCC	Houston Wire & Cable Company
HWKN	Hawkins Inc.
HXL	Hexcel Corp.
HY	Hyster-Yale Materials Handling
HYB	New America High Income Fund
HYD	Market Vectors High-Yield Municipal ETF
HYEM	Market Vectors EM High Yield Bd ETF
HYF	Managed High Yield Plus Fund Inc.
HYG	iShares iBoxx $ High Yield Corporate Bd
HYGH	iShares Interest Rate Hedged High Yld Bd
HYGS	Hydrogenics Corporation
HYHG	ProShares High Yield??Interest Rate Hdgd
HYLD	Peritus High Yield ETF
HYMB	SPDR Nuveen S&P High Yield Municipal Bd
HYS	PIMCO 0-5 Year High Yield Corp Bd ETF
HYT	BlackRock Corporate High Yield Fund VI
HYXU	iShares Global ex USD High Yield Corp Bd
HZNP	Horizon Pharma
HZO	Marinemax Inc.
I	Intelsat S.A.
IACI	IAC/InterActiveCorp
IAE	Voya Asia Pacific High Dividend
IAF	Aberdeen Australia Equity Fund 
IAG	IAMGOLD Corp.
IAH	Internet Architecture HOLDRS
IAI	iShares US Broker-Dealers
IAK	iShares US Insurance
IART	Integra LifeSciences Holdings Corporation
IAT	iShares US Regional Banks
IAU	iShares Gold Trust
IBA	Industrias Bachoco S.A.B. de C.V.
IBB	iShares Nasdaq Biotechnology
IBCA	Intervest Bancshares Corp.
IBCB	iShares iBds Mar 2016 Corp exFincls Term
IBCC	iShares iBds Mar 2018 Corp exFincls
IBCD	iShares iBds Mar 2020 Corp exFincls Term
IBCE	iShares iBds Mar 2023 Corp exFincls Term
IBCP	Independent Bank Corporation
IBDA	iShares iBds Mar 2016 Corporate Term
IBDB	iShares iBds Mar 2018 Corporate Term
IBDC	iShares iBds Mar 2020 Corporate Term
IBDD	iShares iBds Mar 2023 Corporate Term
IBDF	iShares iBds Dec 2016 Corporate Term
IBIO	iBio
IBKC	IberiaBank Corp.
IBKR	Interactive Brokers Group
IBM	International Business Machines Corporation
IBMD	iShares iBonds Sep2015 AMT-FreeMuni Bd
IBME	iShares iBonds Sep2016 AMT-FreeMuni Bd
IBMF	iShares iBonds Sep2017 AMT-FreeMuni Bd
IBMG	iShares iBonds Sep2018 AMT-FreeMuni Bd
IBMH	iShares iBonds Sep2019 AMT-FreeMuni Bd
IBN	ICICI Bank Ltd.
IBND	SPDR Barclays International Corporate Bd
IBOC	International Bancshares Corporation
IBP	Installed Building Products
IBTX	Independent Bank Group
ICA	Empresas ICA
ICAD	iCAD
ICB	Morgan Stanley Income Securities Inc.
ICCC	ImmuCell Corp.
ICE	Intercontinental Exchange
ICEL	Cellular Dynamics International
ICF	iShares Cohen & Steers REIT
ICFI	ICF International Inc.
ICGE	ICG Group
ICI	iPath Optimized Currency Carry ETN
ICLD	InterCloud Systems
ICLN	iShares Global Clean Energy
ICLR	ICON Public Limited Company
ICN	WisdomTree Indian Rupee Strategy
ICOL	iShares MSCI Colombia Capped
ICON	Iconix Brand Group
ICPT	Intercept Pharmaceuticals
ICUI	ICU Medical
IDA	IdaCorp
IDCC	InterDigital
IDHB	PowerShares S&P Intl Dev Hi Beta ETF
IDHQ	PowerShares S&P Intl Dev Hi Qual ETF
IDI	Tiger Media
IDLV	PowerShares S&P Intl Dev Low Volatil ETF
IDN	Intellicheck Mobilisa
IDOG	ALPS International Sector Div Dogs ETF
IDRA	Idera Pharmaceuticals
IDSA	Industrial Services of America
IDSY	ID Systems Inc.
IDT	IDT Corporation
IDTI	Integrated Device Technology
IDU	iShares US Utilities
IDV	iShares International Select Div
IDX	Market Vectors Indonesia ETF
IDXJ	Market Vectors Indonesia Small-Cap ETF
IDXX	IDEXX Laboratories
IEC	IEC Electronics Corp.
IEF	iShares 7-10 Year Treasury Bond
IEI	iShares 3-7 Year Treasury Bond
IEIL	iShares Enhanced International Large-Cap
IEIS	iShares Enhanced International Small-Cap
IELG	iShares Enhanced US Large-Cap
IEMF	EGShares TCW EM Interm Trm IG Bd ETF
IEO	iShares US Oil&Gas Explor&Prodtn
IEP	Icahn Enterprises
IESC	Integrated Electrical Services
IESM	iShares Enhanced US Small-Cap
IEUR	iShares Core MSCI Europe
IEV	iShares Europe
IEX	IDEX Corporation
IEZ	iShares US Oil Equipment&Services
IF	Aberdeen Indonesia Fund
IFAS	iShares Asia Developed Real Estate
IFEU	iShares Europe Devlopd Real Estate
IFF	International Flavors & Fragrances Inc.
IFGL	iShares International Dev Rel Est
IFMI	Institutional Financial Markets
IFN	India Fund
IFNA	iShares North America Real Estate
IFON	Infosonics Corp.
IFSM	iShares Developed Sm-Cap ex North Amer
IFT	Imperial Holdings
IG	IGI
IGA	ING Global Advantage and Premium Opportunity Fund
IGC	India Globalization Capital
IGD	ING Global Equity Dividend & Premium Opportunity Fund
IGE	iShares North American Natural Resources
IGF	iShares Global Infrastructure
IGHG	ProShares Investment Grade??Intr Rt Hdgd
IGLD	Internet Gold Golden Lines Ltd.
IGM	iShares North American Tech
IGN	iShares North American Tech-Multimd Ntwk
IGOV	iShares International Treasury Bond
IGR	CBRE Clarion Global Real Estate
IGT	International Game Technology
IGTE	iGATE Corporation
IGU	ProShares Ultra Investment Grade Corp
IGV	iShares North American Tech-Software
IHC	Independence Holding Co.
IHDG	WisdomTree International Hedged Div Gr
IHE	iShares US Pharmaceuticals
IHF	iShares US Healthcare Providers
IHG	Intercontinental Hotels Group plc
IHI	iShares US Medical Devices
IHS	IHS Inc.
IHT	Innsuites Hospitality Trust
IHY	Market Vectors Intl Hi-Yld Bd ETF
IID	Voya International High Dividen
IIF	Morgan Stanley India Investment
III	Information Services Group
IIIN	Insteel Industries Inc.
IIJI	Internet Initiative Japan Inc.
IILG	Interval Leisure Group
IIM	Invesco Value Municipal Income 
IIN	Intricon Corp.
IIVI	II-VI Incorporated
IJH	iShares Core S&P Mid-Cap
IJJ	iShares S&P Mid-Cap 400 Value
IJK	iShares S&P MidCap 400 Growth
IJNK	SPDR Barclays Intl Hi Yld Bd ETF
IJR	iShares Core S&P Small-Cap
IJS	iShares S&P Small-Cap 600 Value
IJT	iShares S&P Small-Cap 600 Growth
IKAN	Ikanos Communications
IKGH	Iao Kun Group Holding Company Limited
IKNX	Ikonics Corp.
IL	IntraLinks Holdings
ILB	PIMCO Global Advantage Infl-Lkd Bd ETF
ILF	iShares Latin America 40
ILMN	Illumina Inc.
ILTB	iShares Core Long-Term USD Bond
IM	Ingram Micro Inc.
IMAX	IMAX Corporation
IMCB	Intermountain Community Bancorp
IMGN	ImmunoGen
IMH	Impac Mortgage Holdings Inc.
IMI	Intermolecular
IMKTA	Ingles Markets
IMMR	Immersion Corporation
IMMU	Immunomedics Inc.
IMMY	Imprimis Pharmaceuticals
IMN	Imation Corp.
IMO	Imperial Oil Ltd.
IMOS	ChipMOS TECHNOLOGIES
IMPV	Imperva Inc.
IMRS	IMRIS
IMS	IMS Health Holdings
IMUC	ImmunoCellular Therapeutics
INAP	Internap Network Services Corp.
INB	Cohen & Steers Global Income Builder
INBK	First Internet Bancorp
INCO	EGShares India Consumer ETF
INCY	Incyte Corporation
INDA	iShares MSCI India
INDB	Independent Bank Corp.
INDL	Direxion Daily India Bull 3X Shares
INDY	iShares India 50
INFA	Informatica Corporation
INFI	Infinity Pharmaceuticals
INFN	Infinera Corporation
INFU	InfuSystem Holdings
INFY	Infosys Ltd.
ING	ING Groep N.V.
INGN	Inogen
INGR	Ingredion Incorporated
ININ	Interactive Intelligence Group Inc.
INKM	SPDR SSgA Income Allocation ETF
INN	Summit Hotel Properties
INO	Inovio Pharmaceuticals
INOD	Innodata Inc.
INP	iPath MSCI India Index ETN
INPH	Interphase Corp.
INR	Market Vectors Indian Rupee/USD ETN
INS	Intelligent Systems Corporation
INSM	Insmed Incorporated
INSY	INSYS Therapeutics
INT	World Fuel Services Corp.
INTC	Intel Corporation
INTG	The InterGroup Corporation
INTL	INTL FCStone Inc.
INTT	inTEST Corp.
INTU	Intuit Inc.
INTX	Intersections Inc.
INUV	Inuvo
INVE	Identiv
INVN	InvenSense
INVT	Inventergy Global
INWK	InnerWorkings Inc.
INXN	Interxion Holding NV
INXX	EGShares India Infrastructure
INY	SPDR Nuveen Barclays Capital NY Muni Bd
IO	ION Geophysical Corporation
IOC	InterOil Corporation
IOIL	IQ Global Oil Small Cap ETF
IOO	iShares Global 100
IOSP	Innospec Inc.
IOT	Income Opportunity Realty Investors Inc.
IP	International Paper Company
IPAC	iShares Core MSCI Pacific
IPAR	Inter Parfums Inc.
IPAS	iPass Inc.
IPCC	Infinity Property and Casualty Corp.
IPCI	IntelliPharmaCeutics International Inc.
IPCM	IPC The Hospitalist Company
IPD	SPDR S&P International Cons Disc Sector
IPDN	Professional Diversity Network LLC
IPE	SPDR Barclays TIPS
IPF	SPDR S&P International Financial Sector
IPFF	iShares International Pref Stock
IPG	The Interpublic Group of Companies
IPGP	IPG Photonics Corporation
IPHI	Inphi Corporation
IPHS	Innophos Holdings Inc
IPI	Intrepid Potash
IPK	SPDR S&P International Technology Sector
IPN	SPDR S&P International Industrial Sector
IPO	Renaissance IPO ETF
IPS	SPDR S&P International Cons Stapl Sector
IPU	SPDR S&P International Utilities Sector
IPW	SPDR S&P International Energy Sector
IPWR	Ideal Power
IPXL	Impax Laboratories Inc.
IQDE	FlexShares International Qual Div Dfnsv
IQDF	FlexShares International Qual Div
IQDY	FlexShares International Qual Div Dyn
IQI	Invesco Quality Municipal Income Trust
IQNT	Inteliquent
IR	Ingersoll-Rand Plc
IRBT	iRobot Corporation
IRC	Inland Real Estate Corp.
IRDM	Iridium Communications Inc.
IRE	The Governor and Company of the Bank of Ireland
IRET	Investors Real Estate Trust
IRF	International Rectifier Corporation
IRG	Ignite Restaurant Group
IRIX	IRIDEX Corporation
IRL	New Ireland Fund
IRM	Iron Mountain Inc.
IROQ	IF Bancorp
IRR	Voya Natural Resources Equity I
IRS	IRSA Investments and Representations Inc.
IRT	Independence Realty Trust
IRV	SPDR S&P International Materials Sector
IRWD	Ironwood Pharmaceuticals
IRY	SPDR S&P International HealthCare Sector
ISBC	Investors Bancorp Inc.
ISCA	International Speedway Corp.
ISDR	Issuer Direct Corporation
ISH	International Shipholding Corp.
ISHG	iShares 1-3 Year International Trs Bd
ISIG	Insignia Systems Inc.
ISIL	Intersil Corporation
ISIS	Isis Pharmaceuticals
ISL	Aberdeen Israel Fund
ISLE	Isle of Capri Casinos
ISNS	Image Sensing Systems
ISR	IsoRay
ISRA	Market Vectors Israel ETF
ISRG	Intuitive Surgical
ISRL	Isramco Inc.
ISS	iSoftStone Holdings Limited
ISSC	Innovative Solutions & Support Inc.
ISSI	Integrated Silicon Solution Inc.
IST	SPDR S&P International Telecom Sector
IT	Gartner Inc.
ITA	iShares US Aerospace & Defense
ITB	iShares US Home Construction
ITC	ITC Holdings Corp.
ITCI	Intra-Cellular Therapies
ITE	SPDR Barclays Intermediate Term Treasury
ITF	iShares Japan Large-Cap
ITG	Investment Technology Group Inc.
ITI	Iteris
ITIC	Investors Title Co.
ITIP	iShares Intnl Inflation-Linked Bond
ITM	Market Vectors Intermediate Muni ETF
ITMN	InterMune
ITOT	iShares Core S&P Total US Stock Mkt
ITR	SPDR Barclays Cap Interm Term Corp Bnd
ITRI	Itron
ITRN	Ituran Location & Control Ltd.
ITT	ITT Corporation
ITUB	Itau Unibanco Holding S.A.
ITW	Illinois Tool Works Inc.
IUSB	iShares Core Total USD Bond Market
IUSG	iShares Core US Growth
IUSV	iShares Core US Value
IVAC	Intevac Inc.
IVAN	Ivanhoe Energy Inc.
IVC	Invacare Corporation
IVE	iShares S&P 500 Value
IVOG	Vanguard S&P Mid-Cap 400 Growth ETF
IVOO	Vanguard S&P Mid-Cap 400 ETF
IVOP	iPath Inverse S&P 500 VIX ST Fut ETN II
IVOV	Vanguard S&P Mid-Cap 400 Value ETF
IVR	Invesco Mortgage Capital Inc.
IVV	iShares Core S&P 500
IVW	iShares S&P 500 Growth
IVZ	Invesco Ltd.
IWB	iShares Russell 1000
IWC	iShares Micro-Cap
IWD	iShares Russell 1000 Value
IWF	iShares Russell 1000 Growth
IWL	iShares Russell Top 200
IWM	iShares Russell 2000
IWN	iShares Russell 2000 Value
IWO	iShares Russell 2000 Growth
IWP	iShares Russell Mid-Cap Growth
IWR	iShares Russell Mid-Cap
IWS	iShares Russell Mid-Cap Value
IWV	iShares Russell 3000
IWX	iShares Russell Top 200 Value
IWY	iShares Russell Top 200 Growth
IX	ORIX Corporation
IXC	iShares Global Energy
IXG	iShares Global Financials
IXJ	iShares Global Healthcare
IXN	iShares Global Tech
IXP	iShares Global Telecom
IXYS	IXYS Corp.
IYC	iShares US Consumer Services
IYE	iShares US Energy
IYF	iShares US Financials
IYG	iShares US Financial Services
IYH	iShares US Healthcare
IYJ	iShares US Industrials
IYK	iShares US Consumer Goods
IYLD	iShares Morningstar Multi-Asset Income
IYM	iShares US Basic Materials
IYR	iShares US Real Estate
IYT	iShares Transportation Average
IYW	iShares US Technology
IYY	iShares Dow Jones US
IYZ	iShares US Telecommunications
JACK	Jack in the Box Inc.
JACQ	Collabrium Japan Acquisition Corporation
JAH	Jarden Corp.
JAKK	JAKKS Pacific
JASO	JA Solar Holdings Co.
JAXB	Jacksonville Bancorp
JAZZ	Jazz Pharmaceuticals Public Limited Company
JBHT	JB Hunt Transport Services Inc.
JBL	Jabil Circuit Inc.
JBLU	JetBlue Airways Corporation
JBSS	John B Sanfilippo & Son Inc.
JBT	John Bean Technologies Corporation
JCE	Nuveen Core Equity Alpha Fund N
JCI	Johnson Controls Inc.
JCOM	j2 Global
JCP	J. C. Penney Company
JCS	Communications Systems Inc.
JCTCF	Jewett-Cameron Trading Company Ltd.
JD	JD.com
JDD	Nuveen Diversified Dividend & Income Fund
JDST	Direxion Daily Jr Gld Mnrs Bear 3X Shrs
JDSU	JDS Uniphase Corporation
JE	Just Energy Group Inc.
JEC	Jacobs Engineering Group Inc.
JEM	iPath GEMS Index ETN
JEQ	Aberdeen Japan Equity Fund
JFC	JF China Region Fund
JFR	Nuveen Floating Rate Income Fund
JGBD	PowerShares DB 3x Invrs Jp GvBd Futs ETN
JGBS	PowerShares DB Invrs Jpn GovtBd Futs ETN
JGG	Nuveen Global Government Enhanc
JGV	Nuveen Global Value Opportuniti
JGW	JGWPT Holdings Inc.
JHI	John Hancock Investors Trust
JHP	Nuveen Quality Preferred Income
JHS	John Hancock Income Securities Trust
JHX	James Hardie Industries plc
JIVE	Jive Software
JJA	iPath DJ-UBS Agriculture TR Sub-Idx ETN
JJC	iPath DJ-UBS Copper TR Sub-Idx ETN
JJE	iPath DJ-UBS Energy TR Sub-Idx ETN
JJG	iPath DJ-UBS Grains TR Sub-Idx ETN
JJM	iPath DJ-UBS Ind Metals TR Sub-Idx ETN
JJN	iPath DJ-UBS Nickel TR Sub-Idx ETN
JJP	iPath DJ-UBS Prec Metals TR Sub-Idx ETN
JJS	iPath DJ-UBS Softs TR Sub-Idx ETN
JJSF	J&J Snack Foods Corp.
JJT	iPath DJ-UBS Tin TR Sub-Idx ETN
JJU	iPath DJ-UBS Aluminum TR Sub-Idx ETN
JKD	iShares Morningstar Large-Cap
JKE	iShares Morningstar Large-Cap Growth
JKF	iShares Morningstar Large-Cap Value
JKG	iShares Morningstar Mid-Cap
JKH	iShares Morningstar Mid-Cap Growth
JKHY	Jack Henry & Associates Inc.
JKI	iShares Morningstar Mid-Cap Value
JKJ	iShares Morningstar Small-Cap
JKK	iShares Morningstar Small-Cap Growth
JKL	iShares Morningstar Small-Cap Value
JKS	JinkoSolar Holding Co.
JLA	Nuveen Equity Premium Advantage
JLL	Jones Lang LaSalle Incorporated
JMBA	Jamba
JMEI	Jumei International Holding Limited
JMI	JAVELIN Mortgage Investment Corp.
JMP	JMP Group Inc.
JNJ	Johnson & Johnson
JNK	SPDR Barclays High Yield Bond
JNPR	Juniper Networks
JNS	Janus Capital Group
JNUG	Direxion Daily Jr Gld Mnrs Bull 3X Shrs
JO	iPath DJ-UBS Coffee TR Sub-Idx ETN
JOB	General Employment Enterprises Inc.
JOBS	51job Inc.
JOE	The St. Joe Company
JOEZ	Joe's Jeans Inc.
JOF	Japan Smaller Capitalization Fund Inc.
JONE	Jones Energy
JOUT	Johnson Outdoors Inc.
JOY	Joy Global
JPC	Nuveen Multi-Strategy Income & Growth Fund
JPG	Nuveen Equity Premium and Growth Fund
JPGE	JPMorgan Diversified Return Glbl Eq ETF
JPM	JPMorgan Chase & Co.
JPMV	iShares MSCI Japan Minimum Volatility
JPNL	Direxion Daily Japan Bull 3X Shares
JPNS	Direxion Daily Japan Bear 3X Shares
JPP	SPDR Russell/Nomura PRIME Japan
JPS	Nuveen Quality Preferred Income Fund 2
JPX	ProShares UltraShort MSCI Pacific ex-Jpn
JPZ	Nuveen Equity Premium Income Fund
JQC	Nuveen Credit Strategies Income
JRJC	China Finance Online Co.
JRN	Journal Communications Inc.
JRO	Nuveen Floating Rate Income Opportunity Fund
JRS	Nuveen Real Estate Income Fund
JSC	SPDR Russell/Nomura Small Cap Japan
JSN	Nuveen Equity Premium Opportunity Fund
JST	Jinpan International Limited
JTA	Nuveen Tax Advantaged Total Return Strategy Fund
JTD	Nuveen Tax-Advantaged Dividend Growth Fund
JTP	Nuveen Quality Preferred Income Fund
JUNR	Global X Junior Miners ETF
JVA	Coffee Holding Company
JW-A	John Wiley & Sons Inc.
JWN	Nordstrom Inc.
JXI	iShares Global Utilities
JXSB	Jacksonville Bancorp Inc.
JYN	iPath JPY/USD Exchange Rate ETN
K	Kellogg Company
KAI	Kadant Inc.
KALU	Kaiser Aluminum Corporation
KAMN	Kaman Corporation
KANG	iKang Healthcare Group
KAR	KAR Auction Services
KATE	Kate Spade & Company
KB	KB Financial Group
KBA	KraneShares Bosera MSCI China A ETF
KBALB	Kimball International
KBE	SPDR S&P Bank ETF
KBH	KB Home
KBIO	KaloBios Pharmaceuticals
KBR	KBR
KBWB	PowerShares KBW Bank ETF
KBWC	PowerShares KBW Capital Markets ETF
KBWD	PowerShares KBW High Div Yld Fincl ETF
KBWI	PowerShares KBW Insurance ETF
KBWP	PowerShares KBW Prpty & Casualty Ins ETF
KBWR	PowerShares KBW Regional Bank ETF
KBWY	PowerShares KBW Premium Yld Eq REIT ETF
KCAP	KCAP Financial
KCE	SPDR S&P Capital Markets ETF
KCG	KCG Holdings
KCLI	Kansas City Life Insurance Company
KED	Kayne Anderson Energy Development Company
KEF	Korea Equity Fund Inc.
KEG	Key Energy Services Inc.
KELYA	Kelly Services
KEM	KEMET Corp.
KEP	Korea Electric Power Corp.
KEQU	Kewaunee Scientific Corp.
KERX	Keryx Biopharmaceuticals Inc.
KEX	Kirby Corporation
KEY	KeyCorp.
KEYW	The KEYW Holding Corporation
KF	The Korea Fund Inc.
KFFB	Kentucky First Federal Bancorp
KFRC	Kforce Inc.
KFS	Kingsway Financial Services Inc.
KFY	Korn/Ferry International
KFYP	KraneShares CSI New China ETF
KGC	Kinross Gold Corporation
KGJI	Kingold Jewelry
KHI	Deutsche High Income Trust Shar
KIE	SPDR S&P Insurance ETF
KIM	Kimco Realty Corporation
KIN	Kindred Biosciences
KING	King Digital Entertainment plc
KINS	Kingstone Companies
KIOR	KiOR
KIPS	Kips Bay Medical
KIRK	Kirkland's Inc.
KITE	Kite Pharma
KKD	Krispy Kreme Doughnuts
KKR	Kohlberg Kravis Roberts & Co. L.P.
KLAC	KLA-Tencor Corporation
KLD	iShares MSCI USA ESG Select
KLIC	Kulicke and Soffa Industries
KMB	Kimberly-Clark Corporation
KMG	KMG Chemicals Inc.
KMI	Kinder Morgan
KMM	Deutsche  Multi-Market Income T
KMP	Kinder Morgan Energy Partners
KMPR	Kemper Corporation
KMR	Kinder Morgan Management LLC
KMT	Kennametal Inc.
KMX	CarMax Inc.
KN	Knowles Corporation
KND	Kindred Healthcare Inc.
KNDI	Kandi Technolgies Group
KNL	Knoll
KNM	Konami Corp.
KNOP	KNOT Offshore Partners LP
KNOW	Direxion All Cap Insider Sentiment Shrs
KNX	Knight Transportation Inc.
KO	The Coca-Cola Company
KODK	Eastman Kodak Co.
KOF	Coca-Cola FEMSA S.A.B de C.V.
KOG	Kodiak Oil & Gas Corp.
KOL	Market Vectors Coal ETF
KOLD	ProShares UltraShort Bloomberg Natrl Gas
KONA	Kona Grill Inc.
KONE	Kingtone Wirelessinfo Solution Holding Ltd.
KOOL	Cesca Therapeutics Inc.
KOP	Koppers Holdings Inc.
KOPN	Kopin Corporation
KORS	Michael Kors Holdings Limited
KORU	Direxion Daily South Korea Bull 3X Shrs
KORZ	Direxion Daily South Korea Bear 3X Shrs
KOS	Kosmos Energy Ltd.
KOSS	Koss Corporation
KPTI	Karyopharm Therapeutics
KR	The Kroger Co.
KRA	Kraton Performance Polymers Inc.
KRC	Kilroy Realty Corp.
KRE	SPDR S&P Regional Banking ETF
KRFT	Kraft Foods Group
KRG	Kite Realty Group Trust
KRNY	Kearny Financial Corp.
KRO	Kronos Worldwide
KROO	IQ Australia Small Cap ETF
KRS	ProShares Short KBW Regional Banking
KRU	ProShares Ultra KBW Regional Banking
KS	KapStone Paper and Packaging Corporation
KSM	Deutsche Strategic Municiple In
KSS	Kohl's Corp.
KST	Deutsche Strategic Income Trust
KSU	Kansas City Southern
KT	KT Corp.
KTCC	Key Tronic Corp.
KTEC	Key Technology
KTF	Deutsche Municiple Income Trust
KTOS	Kratos Defense & Security Solutions
KTWO	K2M Group Holdings
KUTV	Ku6 Media Co.
KVHI	KVH Industries Inc.
KW	Kennedy-Wilson Holdings
KWK	Quicksilver Resources Inc.
KWR	Quaker Chemical Corporation
KWT	Market Vectors Solar Energy ETF
KXI	iShares Global Consumer Staples
KYE	Kayne Anderson Energy Total Return Fund
KYN	Kayne Anderson MLP Investment C
KYO	Kyocera Corp.
KYTH	Kythera Biopharmaceuticals
KZ	Kongzhong Corp.
L	Loews Corporation
LABC	Louisiana Bancorp
LABL	Multi-Color Corp.
LACO	Lakes Entertainment Inc.
LAD	Lithia Motors Inc.
LADR	Ladder Capital Corp
LAG	SPDR Barclays Aggregate Bond
LAKE	Lakeland Industries Inc.
LALT	PowerShares Multi-Strategy Alt ETF
LAMR	Lamar Advertising Co.
LANC	Lancaster Colony Corporation
LAND	Gladstone Land Corporation
LAQ	Aberdeen Latin America Equity Fund
LARK	Landmark Bancorp Inc.
LAS	Lentuo International Inc.
LATM	Market Vectors Latin America Sm-Cp ETF
LAWS	Lawson Products Inc.
LAYN	Layne Christensen Company
LAZ	Lazard Ltd.
LB	L Brands
LBAI	Lakeland Bancorp Inc.
LBF	Deutsche Global High Income Fund
LBIX	Leading Brands Inc.
LBJ	Direxion Daily Latin America Bull 3X Shs
LBMH	Liberator Medical Holdings
LBND	PowerShares DB 3x Long 25+Yr Trsy Bd ETN
LBTYA	Liberty Global plc
LBY	Libbey Inc.
LCI	Lannett Company
LCM	Advent/Claymore Enhanced Growth
LCNB	LCNB Corp.
LCUT	Lifetime Brands
LD	iPath DJ-UBS Lead TR Sub-Idx ETN
LDF	Latin American Discovery Fund Inc.
LDL	Lydall Inc.
LDOS	Leidos Holdings
LDR	Landauer Inc.
LDRH	LDR Holding Corporation
LE	Lands' End
LEA	Lear Corp.
LEAF	Springleaf Holdings
LECO	Lincoln Electric Holdings Inc.
LEDD	iPath Pure Beta Lead ETN
LEDS	SemiLEDs Corporation
LEE	Lee Enterprises
LEG	Leggett & Platt
LEI	Lucas Energy
LEJU	Leju Holdings Limited
LEN	Lennar Corp.
LEO	Dreyfus Strategic Municipals
LF	LeapFrog Enterprises Inc.
LFC	China Life Insurance Co. Ltd.
LFL	LATAM Airlines Group S.A.
LFUS	Littelfuse Inc.
LFVN	Lifevantage Corporation
LG	The Laclede Group
LGCY	Legacy Reserves LP
LGF	Lions Gate Entertainment Corp.
LGI	Lazard Global Total Return and Income Fund
LGIH	LGI Homes
LGL	The LGL Group
LGLV	SPDR Russell 1000 Low Volatility ETF
LGND	Ligand Pharmaceuticals Incorporated
LGP	Lehigh Gas Partners LP
LH	Laboratory Corp. of America Holdings
LHCG	LHC Group
LHO	LaSalle Hotel Properties
LII	Lennox International
LIME	Lime Energy Co.
LIN	LIN Media LLC
LINC	Lincoln Educational Services Corporation
LINE	Linn Energy
LINTA	Liberty Interactive Corporation
LION	Fidelity Southern Corporation
LIOX	Lionbridge Technologies Inc.
LIQD	Liquid Holdings Group
LIQT	LiqTech International
LIT	Global X Lithium ETF
LITB	LightInTheBox Holding Co.
LIVE	LiveDeal
LJPC	La Jolla Pharmaceutical Co.
LKFN	Lakeland Financial Corp.
LKQ	LKQ Corp.
LL	Lumber Liquidators Holdings
LLL	L-3 Communications Holdings Inc.
LLNW	Limelight Networks
LLTC	Linear Technology Corporation
LLY	Eli Lilly and Company
LM	Legg Mason Inc.
LMAT	LeMaitre Vascular
LMCA	Liberty Media Corporation
LMIA	LMI Aerospace Inc.
LMNR	Limoneira Company
LMNS	Lumenis Ltd.
LMNX	Luminex Corporation
LMOS	Lumos Networks Corp.
LMT	Lockheed Martin Corporation
LNBB	LNB Bancorp Inc.
LNC	Lincoln National Corporation
LNCE	Snyder's-Lance
LNCO	Linn Co
LND	Brasilagro Companhia Brasileira de Propriedades Agr
LNDC	Landec Corp.
LNG	Cheniere Energy
LNKD	LinkedIn Corporation
LNN	Lindsay Corporation
LNT	Alliant Energy Corporation
LO	Lorillard
LOAN	Manhattan Bridge Capital
LOCK	LifeLock
LOCM	Local Corporation
LOCO	El Pollo Loco Holdings
LODE	Comstock Mining
LOGI	Logitech International SA
LOGM	LogMeIn
LOJN	LoJack Corporation
LONG	eLong Inc.
LOOK	LookSmart
LOPE	Grand Canyon Education
LOR	Lazard World Dividend & Income 
LORL	Loral Space & Communications
LOV	Spark Networks
LOW	Lowe's Companies Inc.
LPCN	Lipocine Inc.
LPDX	LipoScience
LPHI	Life Partners Holdings
LPI	Laredo Petroleum
LPL	LG Display Co.
LPLA	LPL Financial Holdings Inc.
LPNT	Lifepoint Hospitals Inc.
LPSB	Laporte Bancorp
LPSN	LivePerson Inc.
LPT	Liberty Property Trust
LPTH	LightPath Technologies
LPTN	Lpath Inc.
LPX	Louisiana-Pacific Corp.
LQ	La Quinta Holdings Inc.
LQD	iShares iBoxx $ Invst Grade Crp Bond
LQDH	iShares Interest Rate Hedged Corp Bd
LQDT	Liquidity Services
LRAD	LRAD Corporation
LRCX	Lam Research Corporation
LRE	LRR Energy
LRN	K12
LRY	Liberty Property Trust
LSBI	LSB Financial Corp.
LSBK	Lake Shore Bancorp Inc.
LSC	ELEMENTS S&P CTI ETN
LSCC	Lattice Semiconductor Corporation
LSG	Lake Shore Gold Corp.
LSTK	iPath Pure Beta Livestock ETN
LSTR	Landstar System Inc.
LTBR	Lightbridge Corp.
LTC	LTC Properties Inc.
LTL	ProShares Ultra Telecommunications
LTM	Life Time Fitness
LTPZ	PIMCO 15+ Year U.S. TIPS ETF
LTRE	Learning Tree International Inc.
LTRX	Lantronix
LTS	Ladenburg Thalmann Financial Services Inc.
LUB	Luby's
LUK	Leucadia National Corporation
LULU	Lululemon Athletica Inc.
LUNA	Luna Innovations Incorporated
LUV	Southwest Airlines Co.
LUX	Luxottica Group SpA
LVL	Guggenheim S&P Global Div Opps Idx ETF
LVLT	Level 3 Communications
LVNTA	Liberty Ventures
LVS	Las Vegas Sands Corp.
LWAY	Lifeway Foods Inc.
LWC	SPDR Barclays Long CorpTerm Bond ETF
LXFR	Luxfer Holdings PLC
LXFT	Luxoft Holding
LXK	Lexmark International Inc.
LXP	Lexington Realty Trust
LXRX	Lexicon Pharmaceuticals
LXU	LSB Industries Inc.
LYB	LyondellBasell Industries NV
LYG	Lloyds Banking Group plc
LYTS	LSI Industries Inc.
LYV	Live Nation Entertainment
LZB	La-Z-Boy Incorporated
M	Macy's
MA	MasterCard Incorporated
MAA	Mid-America Apartment Communities Inc.
MAB	Eaton Vance Massachusetts Municipal Bond Fund
MAC	The Macerich Company
MACK	Merrimack Pharmaceuticals
MAG	Magnetek Inc.
MAGS	Magal Security Systems Ltd.
MAIN	Main Street Capital Corporation
MAKO	MAKO Surgical Corp.
MAMS	MAM Software Group
MAN	ManpowerGroup Inc.
MANH	Manhattan Associates
MANT	ManTech International Corporation
MANU	Manchester United plc
MAR	Marriott International
MARA	Marathon Patent Group
MARK	Remark Media
MARPS	Marine Petroleum Trust
MAS	Masco Corporation
MASI	Masimo Corporation
MAT	Mattel
MATH	AdvisorShares Meidell Tacticl Advtge ETF
MATL	Direxion Daily Basic Matls Bull 3X Shrs
MATR	Mattersight Corporation
MATW	Matthews International Corporation
MATX	Matson
MAV	Pioneer Municipal High Income Advantage Trust
MAYS	JW Mays Inc.
MBB	iShares MBS
MBFI	MB Financial Inc.
MBG	SPDR Barclays Mortgage Backed Bond ETF
MBI	MBIA Inc.
MBII	Marrone Bio Innovations
MBIS	Mediabistro Inc.
MBLX	Metabolix
MBRG	Middleburg Financial Corporation
MBT	Mobile Telesystems OJSC
MBTF	MBT Financial Corp.
MBVT	Merchants Bancshares Inc.
MBWM	Mercantile Bank Corp.
MC	Moelis & Company
MCA	Blackrock MuniYield California 
MCBC	Macatawa Bank Corp.
MCBK	Madison County Financial
MCC	Medley Capital Corporation
MCD	McDonald's Corp.
MCEP	Mid-Con Energy Partners
MCF	Contango Oil & Gas Company
MCGC	MCG Capital Corporation
MCHP	Microchip Technology Inc.
MCHX	Marchex
MCI	Babson Capital Corporate Invest
MCK	McKesson Corporation
MCN	Madison/Claymore Covered Call & Equity Strategy Fund
MCO	Moody's Corporation
MCOX	Mecox Lane Limited
MCP	Molycorp
MCR	MFS Charter Income Trust Common
MCRI	Monarch Casino & Resort Inc.
MCRL	Micrel Inc.
MCRO	IQ Hedge Macro Tracker ETF
MCRS	MICROS Systems
MCS	The Marcus Corporation
MCY	Mercury General Corporation
MCZ	Mad Catz Interactive Inc.
MD	MEDNAX
MDAS	MedAssets
MDC	MDC Holdings Inc.
MDCA	MDC Partners Inc.
MDCI	Medical Action Industries Inc.
MDCO	The Medicines Company
MDD	SPDR S&P International Mid Cap
MDGN	Medgenics
MDIV	First Trust Multi-Asset Diversified Inc
MDLL	Direxion Daily Mid Cap Bull 2X Shares
MDLZ	Mondelez International
MDM	Mountain Province Diamonds Inc.
MDP	Meredith Corporation
MDR	McDermott International Inc.
MDRX	Allscripts Healthcare Solutions
MDSO	Medidata Solutions
MDT	Medtronic
MDU	MDU Resources Group Inc.
MDVN	Medivation
MDW	Midway Gold Corp.
MDWD	MediWound Ltd.
MDXG	MiMedx Group
MDY	SPDR S&P MidCap 400
MDYG	SPDR S&P 400 Mid Cap Growth ETF
MDYV	SPDR S&P 400 Mid Cap Value ETF
MEA	Metalico Inc.
MEAS	Measurement Specialties Inc.
MED	Medifast Inc.
MEET	MeetMe
MEG	Media General
MEI	Methode Electronics
MEIL	Methes Energies International Ltd.
MEIP	MEI Pharma
MELA	MELA Sciences
MELI	Mercadolibre
MEMP	Memorial Production Partners LP
MEN	BlackRock MuniEnhanced Fund
MENT	Mentor Graphics Corp.
MEOH	Methanex Corporation
MEP	Midcoast Energy Partners
MERC	Mercer International Inc.
MERU	Meru Networks
MES	Market Vectors Gulf States ETF
MET	MetLife
METR	Metro Bancorp
MFA	MFA Financial
MFC	Manulife Financial Corporation
MFD	Macquarie/First Trust Global Infrastructure/Utilities Dividend & Income Fund
MFG	Mizuho Financial Group
MFI	MicroFinancial Inc.
MFL	BlackRock MuniHoldings Insured Investment Fund
MFLX	Multi-Fineline Electronix
MFM	MFS Municipal Income Trust
MFNC	Mackinac Financial Corporation
MFRI	MFRI
MFRM	Mattress Firm Holding Corp.
MFSF	Mutualfirst Financial Inc.
MFT	Blackrock MuniYield Investment 
MFV	MFS Special Value Trust Common 
MG	Mistras Group
MGA	Magna International Inc.
MGAM	Multimedia Games Holding Company
MGC	Vanguard Mega Cap ETF
MGCD	MGC Diagnostics Corporation
MGEE	MGE Energy Inc.
MGF	MFS Government Markets Income Trust
MGH	Minco Gold Corporation
MGI	Moneygram International Inc.
MGIC	Magic Software Enterprises Ltd.
MGK	Vanguard Mega Cap Growth Index ETF
MGLN	Magellan Health
MGM	MGM Resorts International
MGN	Mines Management
MGNX	MacroGenics
MGPI	MGP Ingredients Inc.
MGRC	McGrath Rentcorp
MGT	MGT Capital Investments
MGU	Macquarie Global Infrastructure
MGV	Vanguard Mega Cap Value ETF
MGYR	Magyar Bancorp
MHD	Blackrock MuniHoldings Fund
MHE	BlackRock Massachusetts Health and Education Tax-Exempt Trust
MHF	Western Asset Municipal High Income Fund Inc.
MHFI	McGraw Hill Financial
MHGC	Morgans Hotel Group Co.
MHH	Mastech Holdings
MHI	Pioneer Municipal High Income Trust
MHK	Mohawk Industries Inc.
MHLD	Maiden Holdings
MHN	Blackrock MuniHoldings New York
MHO	M/I Homes
MHR	Magnum Hunter Resources Corp.
MHY	Western Asset Managed High Income Fund Inc.
MIC	Macquarie Infrastructure Company LLC
MICT	Micronet Enertec Technologies
MIDD	Middleby Corp.
MIDU	Direxion Daily Mid Cap Bull 3X Shares
MIDZ	Direxion Daily Mid Cap Bear 3X Shares
MIG	Meadowbrook Insurance Group Inc.
MIL	MFC Industrial Ltd.
MILL	Miller Energy Resources
MIN	MFS Intermediate Income Trust C
MINC	AdvisorShares Newfleet Mult-Sect Inc ETF
MIND	Mitcham Industries Inc.
MINI	Mobile Mini
MINT	PIMCO Enhanced Short Maturity ETF
MITK	Mitek Systems
MITL	Mitel Networks Corporation
MITSY	Mitsui & Co. Ltd.
MITT	AG Mortgage Investment Trust
MIXT	MiX Telematics Limited
MIY	BlackRock MuniYield Michigan Insured Fund
MJI	Blackrock MuniYield New Jersey 
MJN	Mead Johnson Nutrition Company
MKC	McCormick & Company
MKL	Markel Corp.
MKSI	MKS Instruments
MKTAY	Makita Corp.
MKTO	Marketo
MKTX	MarketAxess Holdings Inc.
MLAB	Mesa Laboratories Inc.
MLHR	Herman Miller Inc.
MLI	Mueller Industries Inc.
MLM	Martin Marietta Materials Inc.
MLN	Market Vectors Long Municipal ETF
MLNK	ModusLink Global Solutions
MLNX	Mellanox Technologies
MLP	Maui Land & Pineapple Company
MLPG	UBS E-TRACS Alerian Natural Gas MLP ETN
MLPI	UBS E-TRACS Alerian MLP Infrastrctr ETN
MLPJ	Global X Junior MLP ETF
MLPL	UBS E-TRACS 2x Long Alerian MLP Infr ETN
MLPN	Credit Suisse Cushing 30 MLP Index ETN
MLPS	UBS E-TRACS 1x Shrt Alerian MLP Infr ETN
MLPW	UBS E-TRACS MLP Wells Fargo ETN
MLPX	Global X MLP & Energy Infrastructure ETF
MLPY	Morgan Stanley Cushing MLP High Inc ETN
MLR	Miller Industries Inc.
MLVF	Malvern Bancorp
MM	Millennial Media Inc.
MMC	Marsh & McLennan Companies
MMI	Marcus & Millichap
MMLP	Martin Midstream Partners LP
MMM	3M Company
MMP	Magellan Midstream Partners LP
MMS	MAXIMUS
MMSI	Merit Medical Systems
MMT	MFS Multimarket Income Trust Co
MMU	Western Asset Managed Municipal
MMV	Eaton Vance Massachusetts Municipal Income Trust
MMYT	MakeMyTrip Limited
MN	Manning & Napier
MNA	IQ Merger Arbitrage ETF
MNDL	Mandalay Digital Group
MNDO	MIND C.T.I.
MNE	BlackRock Muni New York Intermediate Duration Fund
MNGA	Magnegas Corporation
MNI	The McClatchy Company
MNK	Mallinckrodt plc
MNKD	MannKind Corp.
MNOV	MediciNova Inc.
MNP	Western Asset Municipal Partner
MNR	Monmouth Real Estate Investment Corp.
MNRK	Monarch Financial Holdings
MNRO	Monro Muffler Brake Inc.
MNST	Monster Beverage Corporation
MNTA	Momenta Pharmaceuticals Inc.
MNTG	MTR Gaming Group
MNTX	Manitex International
MO	Altria Group Inc.
MOBI	Sky-mobi Limited
MOBL	MobileIron
MOC	Command Security Corp.
MOCO	MOCON Inc.
MOD	Modine Manufacturing Company
MOFG	MidWest One Financial Group
MOG-A	Moog Inc.
MOH	Molina Healthcare
MOM	QuantShares US Market Neut Momentum ETF
MON	Monsanto Company
MONT	Montage Technology Group Limited
MONY	iShares Financials Bond
MOO	Market Vectors Agribusiness ETF
MORN	Morningstar Inc.
MOS	The Mosaic Company
MOSY	MoSys
MOV	Movado Group
MOVE	Move
MPA	BlackRock Muniyield Pennsylvania Insured Fund
MPAA	Motorcar Parts of America
MPB	Mid Penn Bancorp Inc.
MPC	Marathon Petroleum Corporation
MPEL	Melco Crown Entertainment Limited
MPET	Magellan Petroleum Corporation
MPLX	MPLX LP
MPO	Midstates Petroleum Company
MPV	MassMutual Participation Investors
MPW	Medical Properties Trust Inc.
MPWR	Monolithic Power Systems Inc.
MPX	Marine Products Corp.
MQT	BlackRock MuniYield Quality Fund II
MQY	BlackRock MuniYield Quality Fund
MR	Mindray Medical International Limited
MRC	MRC Global Inc.
MRCC	Monroe Capital Corporation
MRCY	Mercury Systems
MRD	Memorial Resource Development Corp.
MRF	American Income Fund Inc.
MRGE	Merge Healthcare Incorporated
MRH	Montpelier Re Holdings Ltd.
MRIN	Marin Software Incorporated
MRK	Merck & Co. Inc.
MRKT	Markit Ltd.
MRLN	Marlin Business Services Corp.
MRO	Marathon Oil Corporation
MRTN	Marten Transport Ltd.
MRTX	Mirati Therapeutics
MRVC	MRV Communications
MRVL	Marvell Technology Group Ltd.
MS	Morgan Stanley
MSA	MSA Safety Incorporated
MSB	Mesabi Trust
MSBF	MSB Financial Corp.
MSCC	Microsemi Corporation
MSCI	MSCI Inc.
MSD	Morgan Stanley Emerging Markets Debt Fund Inc.
MSEX	Middlesex Water Co.
MSF	Morgan Stanley Emerging Markets Fund Inc.
MSFG	MainSource Financial Group
MSFT	Microsoft Corporation
MSG	The Madison Square Garden Company
MSI	Motorola Solutions
MSL	Midsouth Bancorp Inc.
MSM	MSC Industrial Direct Co. Inc.
MSN	Emerson Radio Corp.
MSO	Martha Stewart Living Omnimedia Inc.
MSON	Misonix Inc.
MSP	Madison Strategic Sector Premium Fund
MSTR	MicroStrategy Inc.
MSTX	Mast Therapeutics
MT	ArcelorMittal
MTB	M&T Bank Corporation
MTD	Mettler-Toledo International Inc.
MTDR	Matador Resources Company
MTEX	Mannatech
MTG	MGIC Investment Corp.
MTGE	American Capital Mortgage Investment Corp.
MTH	Meritage Homes Corporation
MTK	SPDR Morgan Stanley Technology ETF
MTL	Mechel OAO
MTN	Vail Resorts Inc.
MTOR	Meritor
MTR	Mesa Royalty Trust
MTRN	Materion Corporation
MTRX	Matrix Service Company
MTS	Montgomery Street Income Securities Inc.
MTSC	MTS Systems Corporation
MTSI	M/A-Com Technology Solutions Holdings
MTSL	MER Telemanagement Solutions Ltd.
MTSN	Mattson Technology Inc.
MTU	Mitsubishi UFJ Financial Group
MTUM	iShares MSCI USA Momentum Factor
MTW	The Manitowoc Company
MTX	Minerals Technologies Inc.
MTZ	MasTec
MU	Micron Technology Inc.
MUA	BlackRock MuniAssets Fund
MUAC	iShares 2014 AMT-Free Muni Term
MUB	iShares National AMT-Free Muni Bond
MUC	BlackRock MuniHoldings California Insured Fund
MUE	Blackrock MuniHoldings Quality 
MUH	BlackRock MuniHoldings Fund II
MUI	BlackRock Muni Intermediate Duration Fund
MUJ	BlackRock MuniHoldings New Jersey Insured Fund
MUNI	PIMCO Intermediate Municipal Bond ETF
MUR	Murphy Oil Corporation
MUS	Blackrock MuniHoldings Quality 
MUSA	Murphy USA Inc.
MUX	McEwen Mining Inc.
MVC	MVC Capital
MVF	BlackRock MuniVest Fund
MVG	MAG Silver Corp.
MVIS	Microvision Inc.
MVNR	Mavenir Systems
MVO	MV Oil Trust
MVT	BlackRock MuniVest Fund II
MVV	ProShares Ultra MidCap400
MW	The Men's Wearhouse
MWA	Mueller Water Products
MWE	MarkWest Energy Partners
MWIV	MWI Veterinary Supply
MWRX	MergeWorthRx Corp.
MWV	MeadWestvaco Corporation
MWW	Monster Worldwide
MX	MagnaChip Semiconductor Corporation
MXA	Minnesota Municipal Income Portfolio Inc.
MXC	Mexco Energy Corporation
MXE	Mexico Equity & Income Fund Inc.
MXF	Mexico Fund
MXI	iShares Global Materials
MXIM	Maxim Integrated Products
MXL	MaxLinear
MXN	First American Minnesota Municipal Income Fund II Inc.
MXT	Maxcom Telecomunicaciones S.A.B. de C.V.
MXWL	Maxwell Technologies
MY	China Ming Yang Wind Power Group Limited
MYC	Blackrock MuniYield California Fund
MYCC	ClubCorp Holdings
MYD	Blackrock MuniYield Fund
MYE	Myers Industries Inc.
MYF	BlackRock MuniYield Investment Fund
MYGN	Myriad Genetics Inc.
MYI	Blackrock MuniYield Insured Fund
MYJ	BlackRock MuniYield New Jersey Fund
MYL	Mylan
MYM	BlackRock MuniYield Michigan Insured Fund II
MYN	BlackRock MuniYield New York Insured Fund
MYOS	MYOS Corporation
MYRG	MYR Group
MYY	ProShares Short MidCap400
MZA	BlackRock Muniyield Arizona Fund
MZF	Managed Duration Investment Grade Municipal Fund
MZZ	ProShares UltraShort MidCap400
N	NetSuite Inc.
NAC	Nuveen California Dividend Advantage Municipal Fund
NAD	Nuveen Dividend Advantage Municipal Fund
NAII	Natural Alternatives International Inc.
NAK	Northern Dynasty Minerals Ltd.
NAN	Nuveen New York Dividend Advantage Municipal Fund
NANO	Nanometrics Incorporated
NAO	Nordic American Offshore Ltd.
NASB	NASB Financial
NASH	LocalShares Nashville Area ETF
NAT	Nordic American Tankers Limited
NATH	Nathan's Famous Inc.
NATI	National Instruments Corporation
NATL	National Interstate Corporation
NATR	Nature's Sunshine Products Inc.
NAUH	National American University Holdings
NAV	Navistar International Corporation
NAVB	Navidea Biopharmaceuticals
NAVG	Navigators Group Inc.
NAVI	Navient Corporation
NAZ	Nuveen Arizona Premium Income Municipal Fund
NBBC	NewBridge Bancorp
NBCB	First NBC Bank Holding Company
NBG	National Bank of Greece SA
NBH	Neuberger Berman Intermediate Municipal Fund Inc.
NBHC	National Bank Holdings Corp.
NBIX	Neurocrine Biosciences Inc.
NBL	Noble Energy
NBN	Northeast Bancorp
NBO	Neuberger Berman New York Intermediate Municipal Fund Inc.
NBR	Nabors Industries Ltd.
NBS	Neostem
NBTB	NBT Bancorp
NBTF	NB&T Financial Group Inc.
NBW	Neuberger Berman California Intermediate Municipal Fund Inc.
NBY	NovaBay Pharmaceuticals
NC	Nacco Industries Inc.
NCA	Nuveen California Municipal Value Fund
NCFT	Norcraft Companies
NCI	Navigant Consulting Inc.
NCIT	NCI
NCMI	National CineMedia
NCQ	NovaCopper Inc.
NCR	NCR Corp.
NCS	NCI Building Systems Inc.
NCT	Newcastle Investment Corp.
NCTY	The9 Limited
NCV	AllianzGI Convertible & Income 
NCZ	AllianzGI Convertible & Income 
NDAQ	The Nasdaq OMX Group
NDLS	Noodles & Company
NDRO	Enduro Royalty Trust
NDSN	Nordson Corporation
NE	Noble Corp.
NEA	Nuveen Insured Tax-Free Advantage Municipal Fund
NEAR	iShares Short Maturity Bond
NECB	Northeast Community Bancorp
NEE	NextEra Energy
NEM	Newmont Mining Corporation
NEN	New England Realty Associates LP
NEO	Neogenomics Inc.
NEOG	Neogen Corp.
NEON	Neonode
NEP	NextEra Energy Partners
NES	Nuverra Environmental Solutions
NETE	Net Element
NEU	NewMarket Corporation
NEWM	New Media Investment Group Inc.
NEWP	Newport Corp.
NEWS	NewStar Financial
NEWT	Newtek Business Services Inc.
NFBK	Northfield Bancorp
NFEC	NF Energy Saving Corp.
NFG	National Fuel Gas Company
NFJ	NFJ Dividend
NFLX	Netflix
NFO	Guggenheim Insider Sentiment ETF
NFRA	FlexShares STOXX Global Broad Infras
NFX	Newfield Exploration Co.
NG	NovaGold Resources Inc.
NGD	New Gold
NGE	Global X Nigeria Index ETF
NGG	National Grid plc
NGHC	National General Holdings Corp.
NGL	NGL Energy Partners LP
NGLS	Targa Resources Partners LP
NGPC	NGP Capital Resources Company
NGS	Natural Gas Services Group Inc.
NGVC	Natural Grocers by Vitamin Cottage
NHC	National Healthcare Corp.
NHI	National Health Investors Inc.
NHS	Neuberger Berman High Yield Strategies Fund
NHTB	New Hampshire Thrift Bancshares Inc.
NI	NiSource Inc.
NIB	iPath DJ-UBS Cocoa TR Sub-Idx ETN
NICE	NICE Systems Ltd.
NICK	Nicholas Financial Inc.
NIHD	NII Holdings Inc.
NILE	Blue Nile Inc.
NIM	Nuveen Select Maturities Municipal Fund
NINI	iPath Pure Beta Nickel ETN
NIO	Nuveen Insured Municipal Opportunity Fund
NJ	Nidec Corporation
NJR	New Jersey Resources Corp.
NKA	Niska Gas Storage Partners LLC
NKE	Nike
NKG	Nuveen Georgia Dividend Advantage Municipal Fund 2
NKSH	National Bankshares Inc.
NKTR	Nektar Therapeutics
NKX	Nuveen Insured California Tax Free Advantage Municipal Fund
NKY	MAXIS Nikkei 225 ETF
NL	NL Industries Inc.
NLNK	NewLink Genetics Corporation
NLR	Market Vectors Uranium+Nuclear Engy ETF
NLS	Nautilus Inc.
NLSN	Nielsen N.V.
NLST	Netlist Inc.
NLY	Annaly Capital Management
NM	Navios Maritime Holdings Inc.
NMA	Nuveen Municipal Advantage Fund
NMBL	Nimble Storage
NMFC	New Mountain Finance Corporation
NMI	Nuveen Municipal Income Fund
NMIH	NMI Holdings
NMM	Navios Maritime Partners L.P.
NMO	Nuveen Municipal Market Opportunity Fund
NMR	Nomura Holdings
NMRX	Numerex Corp.
NMT	Nuveen Massachusetts Premium Income Municipal Fund
NMY	Nuveen Maryland Premium Income Municipal Fund
NMZ	Nuveen Municipal High Income Opportunity Fund
NNA	Navios Maritime Acquisition Corporation
NNBR	NN Inc.
NNC	Nuveen North Carolina Premium Income Municipal Fund
NNI	Nelnet
NNJ	Nuveen New Jersey Premium Income Municipal Fund
NNN	National Retail Properties
NNP	Nuveen New York Performance Plus Municipal Fund
NNVC	NanoViricides
NNY	Nuveen New York Municipal Value Fund
NOA	North American Energy Partners Inc.
NOAH	Noah Holdings Limited
NOBL	ProShares S&P 500 Aristocrats
NOC	Northrop Grumman Corporation
NOG	Northern Oil and Gas
NOK	Nokia Corporation
NOM	Nuveen Missouri Premium Income 
NOR	Noranda Aluminum Holding Corp.
NORD	Nord Anglia Education
NORW	Global X MSCI Norway ETF
NOV	National Oilwell Varco
NOVB	North Valley Bancorp
NOW	ServiceNow
NP	Neenah Paper
NPBC	National Penn Bancshares Inc.
NPD	China Nepstar Chain Drugstore Ltd.
NPF	Nuveen Premier Municipal Income Fund
NPI	Nuveen Premium Income Municipal
NPK	National Presto Industries Inc.
NPM	Nuveen Premium Income Municipal
NPO	EnPro Industries
NPP	Nuveen Performance Plus Municipal Fund
NPSP	NPS Pharmaceuticals
NPT	Nuveen Premium Income Municipal Fund 4
NPTN	NeoPhotonics Corporation
NPV	Nuveen Virginia Premium Income Municipal Fund
NQ	NQ Mobile Inc.
NQI	Nuveen Quality Municipal Fund
NQJ	Nuveen New Jersey Investment Quality Municipal Fund
NQM	Nuveen Investment Quality Municipal Fund
NQP	Nuveen Pennsylvania Investment 
NQS	Nuveen Select Quality Municipal
NQU	Nuveen Quality Income Municipal Fund
NR	Newpark Resources Inc.
NRCIB	National Research Corp.
NRF	NorthStar Realty Finance Corp.
NRG	NRG Energy
NRIM	Northrim Bancorp Inc.
NRK	Nuveen Insured New York Tax-Free Advantage Municipal Fund
NRO	Neuberger Berman Real Estate Securities Income Fund Inc.
NRP	Natural Resource Partners LP
NRT	North European Oil Royalty Trust
NRX	NephroGenex
NRZ	New Residential Investment Corp.
NS	NuStar Energy L.P.
NSANY	Nissan Motor Co.
NSC	Norfolk Southern Corporation
NSEC	National Security Group Inc.
NSH	NuStar GP Holdings
NSIT	Insight Enterprises Inc.
NSL	Nuveen Senior Income Fund
NSLP	New Source Energy Partners L.P.
NSM	Nationstar Mortgage Holdings Inc.
NSP	Insperity
NSPH	Nanosphere
NSPR	InspireMD
NSR	NeuStar
NSSC	Napco Security Technologies
NSTG	NanoString Technologies
NSU	Nevsun Resources Ltd.
NSYS	Nortech Systems Inc.
NTAP	NetApp
NTC	Nuveen Connecticut Premium Income Municipal Fund
NTCT	NetScout Systems
NTES	NetEase
NTGR	Netgear Inc.
NTI	Northern Tier Energy LP
NTIC	Northern Technologies International Corp.
NTK	Nortek Inc.
NTL	Nortel Inversora S.A.
NTLS	NTELOS Holdings Corp.
NTN	NTN Buzztime Inc.
NTP	Nam Tai Property Inc.
NTRI	Nutrisystem
NTRS	Northern Trust Corporation
NTT	Nippon Telegraph and Telephone Corporation
NTWK	NetSol Technologies
NTX	Nuveen Texas Quality Income Municipal Fund
NTZ	Natuzzi SpA
NU	Northeast Utilities
NUAN	Nuance Communications
NUCL	iShares Global Nuclear Energy
NUE	Nucor Corporation
NUGT	Direxion Daily Gold Miners Bull 3X Shrs
NUJ	Nuveen New Jersey Dividend Advantage Municipal Fund 2
NUM	Nuveen Michigan Quality Income 
NUO	Nuveen Ohio Quality Income Municipal Fund
NURO	NeuroMetrix Inc.
NUS	Nu Skin Enterprises Inc.
NUTR	Nutraceutical International Corporation
NUV	Nuveen Municipal Value Fund
NUVA	NuVasive
NVAX	Novavax
NVDA	NVIDIA Corporation
NVDQ	Novadaq Technologies Inc.
NVEC	NVE Corp.
NVEE	NV5 Holdings
NVFY	Nova Lifestyle
NVG	Nuveen Insured Dividend Advantage Municipal Fund
NVGN	Novogen Limited
NVGS	Navigator Holdings Ltd.
NVMI	Nova Measuring Instruments Ltd.
NVO	Novo Nordisk A/S
NVR	NVR
NVS	Novartis AG
NVSL	Naugatuck Valley Financial Corporation
NVTL	Novatel Wireless Inc.
NVX	Nuveen California Dividend Advantage Municipal Fund 2
NWBI	Northwest Bancshares
NWBO	Northwest Biotherapeutics
NWE	Northwestern Corporation
NWFL	Norwood Financial Corp.
NWHM	The New Home Company LLC
NWL	Newell Rubbermaid Inc.
NWLI	National Western Life Insurance Company
NWN	Northwest Natural Gas Company
NWPX	Northwest Pipe Co.
NWSA	News Corporation
NWY	New York & Company Inc.
NX	Quanex Building Products Corporation
NXC	Nuveen California Select Tax-Free Income Portfolio
NXJ	Nuveen New Jersey Dividend Advantage Municipal Fund
NXK	Nuveen New York Dividend Advantage Municipal Fund 2
NXN	Nuveen New York Select Tax-Free Income Portfolio
NXP	Nuveen Select Tax-Free Income Portfolio
NXPI	NXP Semiconductors NV
NXQ	Nuveen Select Tax-Free Income Portfolio 2
NXR	Nuveen Select Tax-Free Income Portfolio 3
NXST	Nexstar Broadcasting Group
NXTM	Nxstage Medical
NXZ	Nuveen Dividend Advatage Municipal Fund 2
NY	iShares NYSE 100
NYC	iShares NYSE Composite
NYCB	New York Community Bancorp Inc.
NYCC	PowerShares NYSE Century ETF
NYF	iShares New York AMT-Free Muni Bond
NYH	Eaton Vance New York Municipal 
NYLD	NRG Yield
NYMT	New York Mortgage Trust Inc.
NYMX	Nymox Pharmaceutical Corporation
NYNY	Empire Resorts Inc.
NYRT	New York REIT
NYT	The New York Times Company
NZF	Nuveen Dividend Advantage Municipal Fund 3
NZH	Nuveen California Dividend Advantage Municipal Fund 3
O	Realty Income Corporation
OABC	Omniamerican Bancorp
OAK	Oaktree Capital Group
OAKS	Five Oaks Investment Corp.
OAS	Oasis Petroleum Inc.
OB	OneBeacon Insurance Group
OBAF	OBA Financial Services
OBAS	Optibase Ltd.
OBCI	Ocean Bio-Chem Inc.
OC	Owens Corning
OCC	Optical Cable Corp.
OCFC	OceanFirst Financial Corp.
OCIP	OCI Partners LP
OCIR	OCI Resources LP
OCLR	Oclaro
OCLS	Oculus Innovative Sciences
OCN	Ocwen Financial Corp.
OCR	Omnicare Inc.
OCRX	Ocera Therapeutics
ODC	Oil-Dri Corp. of America
ODFL	Old Dominion Freight Line Inc.
ODP	Office Depot
OEF	iShares S&P 100
OESX	Orion Energy Systems
OFC	Corporate Office Properties Trust
OFED	Oconee Federal Financial Corp.
OFG	OFG Bancorp
OFIX	Orthofix International N.V.
OFLX	OmegaFlex
OFS	OFS Capital Corporation
OGE	OGE Energy Corp.
OGEN	Oragenics Inc.
OGXI	OncoGenex Pharmaceuticals
OHI	Omega Healthcare Investors Inc.
OHRP	Ohr Pharmaceutical
OI	Owens-Illinois
OIA	Invesco Municipal Income Opportunities Trust
OIBR	Oi SA
OIBR-C	Oi SA
OIH	Market Vectors Oil Services ETF
OII	Oceaneering International
OIIM	O2Micro International Ltd.
OIL	iPath S&P GSCI Crude Oil TR Index ETN
OILT	Oiltanking Partners
OIS	Oil States International Inc.
OKE	ONEOK Inc.
OKS	ONEOK Partners
OKSB	Southwest Bancorp Inc.
OLBK	Old Line Bancshares Inc.
OLED	Universal Display Corp.
OLEM	iPath Pure Beta Crude Oil ETN
OLN	Olin Corp.
OLO	PowerShares DB Crude Oil Long ETN
OLP	One Liberty Properties Inc.
OMAB	Grupo Aeroportuario del Centro Norte
OMC	Omnicom Group Inc.
OMCL	Omnicell
OME	Omega Protein Corporation
OMED	OncoMed Pharmaceuticals
OMER	Omeros Corporation
OMEX	Odyssey Marine Exploration Inc.
OMG	OM Group Inc.
OMI	Owens & Minor Inc.
OMN	OMNOVA Solutions Inc.
ONB	Old National Bancorp.
ONCY	Oncolytics Biotech Inc.
ONE	Higher One Holdings
ONEF	Russell Equity ETF
ONEK	SPDR Russell 1000 ETF
ONEQ	Fidelity Nasdaq Composite Index Tr Stk
ONFC	Oneida Financial Corp.
ONNN	ON Semiconductor Corp.
ONP	Orient Paper
ONTX	Onconova Therapeutics
ONTY	Oncothyreon Inc
ONVI	Onvia Inc.
ONVO	Organovo Holdings
OPB	Opus Bank
OPHC	OptimumBank Holdings Inc.
OPHT	Ophthotech Corporation
OPK	Opko Health
OPLK	Oplink Communications
OPOF	Old Point Financial Corporation
OPTT	Ocean Power Technologies
OPWR	OPOWER
OPXA	Opexa Therapeutics
OPY	Oppenheimer Holdings Inc.
ORA	Ormat Technologies Inc.
ORAN	Orange
ORB	Orbital Sciences Corp.
ORBC	ORBCOMM
ORBK	Orbotech Ltd.
ORBT	Orbit International Corp.
ORCL	Oracle Corporation
OREX	Orexigen Therapeutics
ORI	Old Republic International Corporation
ORIG	Ocean Rig UDW Inc.
ORIT	Oritani Financial Corp.
ORLY	O'Reilly Automotive Inc.
ORM	Owens Realty Mortgage
ORMP	Oramed Pharmaceuticals Inc.
ORN	Orion Marine Group
ORRF	Orrstown Financial Services Inc.
OSBC	Old Second Bancorp Inc.
OSHC	Ocean Shore Holding Co.
OSIR	Osiris Therapeutics
OSIS	OSI Systems
OSK	Oshkosh Corporation
OSMS	Barclays OFI SteelPath MLP ETNs
OSN	Ossen Innovation Co.
OSTK	Overstock.com Inc.
OSUR	OraSure Technologies
OTEL	Otelco Inc.
OTEX	Open Text Corporation
OTIV	On Track Innovations Ltd.
OTTR	Otter Tail Corporation
OUNZ	Merk Gold ETF
OUTR	Outerwall Inc.
OVAS	OvaScience
OVBC	Ohio Valley Banc Corp.
OVLY	Oak Valley Bancorp
OVRL	Overland Storage Inc.
OVTI	OmniVision Technologies
OWW	Orbitz Worldwide
OXBT	Oxygen Biotherapeutics
OXF	Oxford Resource Partners
OXFD	Oxford Immunotec Global PLC
OXGN	OXiGENE
OXM	Oxford Industries Inc.
OXY	Occidental Petroleum Corporation
OZM	Och-Ziff Capital Management Group LLC
OZRK	Bank of the Ozarks
P	Pandora Media
PAA	Plains All American Pipeline
PAAS	Pan American Silver Corp.
PAC	Grupo Aeroportuario del Pacifico S.A.B. de CV
PACB	Pacific Biosciences of California
PACD	Pacific Drilling S.A.
PACW	PacWest Bancorp
PAF	PowerShares FTSE RAFI Asa Pac ex-Jpn ETF
PAG	Penske Automotive Group
PAGG	PowerShares Global Agriculture ETF
PAGP	Plains GP Holdings
PAH	Platform Specialty Products Corporation
PAHC	Phibro Animal Health Corporation
PAI	Western Asset Income Fund
PAL	North American Palladium Ltd.
PALL	ETFS Physical Palladium Shares
PAM	Pampa Energia SA
PANW	Palo Alto Networks
PAR	PAR Technology Corporation
PARN	Parnell Pharmaceuticals Holdings Ltd.
PATK	Patrick Industries Inc.
PATR	Patriot Transportation Holding
PAY	VeriFone Systems
PAYC	Paycom Software
PAYX	Paychex
PB	Prosperity Bancshares Inc.
PBA	Pembina Pipeline Corporation
PBCP	Polonia Bancorp
PBCT	People's United Financial Inc.
PBD	PowerShares Global Clean Energy ETF
PBE	PowerShares Dynamic Biotech & Genome ETF
PBF	PBF Energy Inc.
PBFX	PBF Logistics LP
PBH	Prestige Brands Holdings
PBHC	Pathfinder Bancorp
PBI	Pitney Bowes Inc.
PBIB	Porter Bancorp Inc.
PBIP	Prudential Bancorp
PBJ	PowerShares Dynamic Food & Beverage ETF
PBM	Pacific Booker Minerals Inc.
PBMD	Prima Biomed Ltd.
PBP	PowerShares S&P 500 BuyWrite ETF
PBPB	Potbelly Corporation
PBR	Petroleo Brasileiro
PBR-A	Petroleo Brasileiro
PBS	PowerShares Dynamic Media ETF
PBSK	Poage Bankshares
PBT	Permian Basin Royalty Trust
PBW	PowerShares WilderHill Clean Energy ETF
PBY	Pep Boys - Manny
PBYI	Puma Biotechnology
PCAR	PACCAR Inc.
PCBK	Pacific Continental Corp.
PCCC	PC Connection
PCEF	PowerShares CEF Income Composite ETF
PCF	Putnam High Income Securities Fund
PCG	PG&E Corporation
PCH	Potlatch Corporation
PCK	PIMCO California Municipal Income Fund II
PCL	Plum Creek Timber Co. Inc.
PCLN	The Priceline Group Inc.
PCM	PCM Fund
PCMI	PCM
PCN	PIMCO Corporate Income Fund
PCO	Pendrell Corporation
PCP	Precision Castparts Corp.
PCQ	PIMCO California Municipal Income Fund
PCRX	Pacira Pharmaceuticals
PCTI	PCTEL
PCTY	Paylocity Holding Corporation
PCY	PowerShares Emerging Markets Sov Dbt ETF
PCYC	Pharmacyclics Inc.
PCYG	Park City Group Inc.
PCYO	Pure Cycle Corporation
PDCE	PDC Energy
PDCO	Patterson Companies
PDEX	Pro-Dex Inc.
PDFS	PDF Solutions Inc.
PDII	PDI
PDLI	PDL BioPharma
PDM	Piedmont Office Realty Trust Inc.
PDN	PowerShares FTSE RAFI DvMkt exUS S/M ETF
PDO	Pyramid Oil Company
PDP	PowerShares DWA Momentum ETF
PDS	Precision Drilling Corporation
PDT	John Hancock Patriot Premium Dividend Fund II
PE	Parsley Energy
PEB	Pebblebrook Hotel Trust
PEBK	Peoples Bancorp of North Carolina
PEBO	Peoples Bancorp Inc.
PED	PEDEVCO Corp.
PEG	Public Service Enterprise Group Inc.
PEGA	Pegasystems Inc.
PEGI	Pattern Energy Group Inc.
PEI	Pennsylvania Real Estate Investment Trust
PEIX	Pacific Ethanol
PEJ	PowerShares Dynamic Leisure & Entmnt ETF
PEK	Market Vectors ChinaAMC A-Share ETF
PENN	Penn National Gaming Inc.
PENX	Penford Corporation
PEO	Petroleum & Resources Corporation
PEOP	Peoples Federal Bancshares
PEP	Pepsico
PER	SandRidge Permian Trust
PERF	Perfumania Holdings
PERI	Perion Network Ltd.
PERM	Global X Permanent ETF
PERY	Perry Ellis International Inc.
PES	Pioneer Energy Services Corp.
PESI	Perma-Fix Environmental Services Inc.
PETM	PetSmart
PETS	PetMed Express
PETX	Aratana Therapeutics
PEX	ProShares Global Listed Private Equity
PEY	PowerShares High Yld Eq Div Achiev ETF
PEZ	PowerShares DWA Cnsmr Cyclicals Mom ETF
PF	Pinnacle Foods Inc.
PFBC	Preferred Bank
PFBI	Premier Financial Bancorp Inc.
PFBX	Peoples Financial Corporation
PFD	Flaherty & Crumrine Preferred I
PFE	Pfizer Inc.
PFEM	PowerShares Fdmt Emerg Mkts Lcl Dbt ETF
PFF	iShares US Preferred Stock
PFG	Principal Financial Group Inc.
PFI	PowerShares DWA Financial Momentum ETF
PFIE	Profire Energy
PFIG	PowerShares Fundamental InvGr CorpBd ETF
PFIN	P&F Industries Inc.
PFIS	Peoples Financial Services Corp.
PFL	PIMCO Income Strategy Fund
PFLT	PennantPark Floating Rate Capital Ltd.
PFM	PowerShares Dividend Achievers ETF
PFMT	Performant Financial Corporation
PFN	PIMCO Income Strategy Fund II
PFO	Flaherty & Crumrine Preferred Income Opportunity Fund Incorporated
PFPT	Proofpoint
PFS	Provident Financial Services
PFSI	PennyMac Financial Services
PFSW	PFSweb Inc.
PFXF	Market Vectors Pref Secs exFincls ETF
PG	The Procter & Gamble Company
PGAL	Global X FTSE Portugal 20 ETF
PGC	Peapack-Gladstone Financial Corp.
PGD	iPath Asian & Gulf Currency Reval ETN
PGEM	Ply Gem Holdings
PGF	PowerShares Financial Preferred ETF
PGH	Pengrowth Energy Corporation
PGHY	PowerShares Global ShrtTerm HiYld Bd ETF
PGI	Premiere Global Services
PGJ	PowerShares Golden Dragon China ETF
PGM	iPath DJ-UBS Platinum TR Sub-Idx ETN
PGN	Paragon Offshore Limited
PGNX	Progenics Pharmaceuticals
PGP	PIMCO Global Stocksplus & Income Fund
PGR	Progressive Corp.
PGTI	PGT
PGX	PowerShares Preferred ETF
PH	Parker-Hannifin Corporation
PHB	PowerShares Fundamental HiYld CorpBd ETF
PHD	Pioneer Floating Rate Trust
PHDG	PowerShares S&P 500 Downside Hedged ETF
PHF	Pacholder High Yield Fund
PHG	Koninklijke Philips N.V
PHH	PHH Corporation
PHI	Philippine Long Distance Telephone Company
PHII	PHI Inc.
PHK	PIMCO High Income Fund
PHM	PulteGroup
PHMD	PhotoMedex
PHO	PowerShares Water Resources ETF
PHT	Pioneer High Income Trust
PHX	Panhandle Oil and Gas Inc.
PHYS	Sprott Physical Gold Trust ETV
PICB	PowerShares International Corp Bd ETF
PICK	iShares MSCI Glbl Metals & Mining Prdcrs
PICO	PICO Holdings Inc.
PID	PowerShares Intl Div Achiev ETF
PIE	PowerShares DWA Emerging Markets Mom ETF
PIH	1347 Property Insurance Holdings
PII	Polaris Industries Inc.
PIKE	Pike Corporation
PIM	Putnam Master Intermediate Income Trust
PIN	PowerShares India ETF
PINC	Premier
PIO	PowerShares Global Water ETF
PIP	PharmAthene
PIR	Pier 1 Imports
PIZ	PowerShares DWA Developed Mkts Mom ETF
PJC	Piper Jaffray Companies
PJP	PowerShares Dynamic Pharmaceuticals ETF
PKB	PowerShares Dynamic Building & Const ETF
PKBK	Parke Bancorp Inc.
PKD	Parker Drilling Co.
PKE	Park Electrochemical Corp.
PKG	Packaging Corporation of America
PKI	PerkinElmer Inc.
PKO	Pimco Income Opportunity Fund C
PKOH	Park-Ohio Holdings Corp.
PKT	Procera Networks
PKW	PowerShares Buyback Achievers ETF
PKX	POSCO
PKY	Parkway Properties Inc.
PL	Protective Life Corporation
PLAB	Photronics Inc.
PLBC	Plumas Bancorp
PLCE	The Children's Place
PLCM	Polycom
PLD	Prologis
PLG	Platinum Group Metals Ltd.
PLKI	Popeyes Louisiana Kitchen
PLL	Pall Corporation
PLM	Polymet Mining Corp.
PLMT	Palmetto Bancshares Inc.
PLND	Market Vectors Poland ETF
PLNR	Planar Systems Inc.
PLOW	Douglas Dynamics
PLPC	Preformed Line Products Company
PLT	Plantronics
PLTM	First Trust ISE Global Platinum Index
PLUG	Plug Power Inc.
PLUS	ePlus inc.
PLW	PowerShares 1-30 Laddered Treasury ETF
PLX	Protalix BioTherapeutics
PLXS	Plexus Corp.
PLXT	PLX Technology Inc.
PM	Philip Morris International
PMBC	Pacific Mercantile Bancorp
PMC	PharMerica Corporation
PMCS	PMC-Sierra Inc.
PMD	Psychemedics Corp.
PME	Pingtan Marine Enterprise Ltd.
PMF	PIMCO Municipal Income Fund
PMFG	PMFG
PML	Pimco Municipal Income Fund II 
PMM	Putnam Managed Municipal Income Trust
PMO	Putnam Municipal Opportunities Trust
PMR	PowerShares Dynamic Retail ETF
PMT	PennyMac Mortgage Investment Trust
PMX	PIMCO Municipal Income Fund III
PNBK	Patriot National Bancorp Inc.
PNC	The PNC Financial Services Group
PNF	PIMCO New York Municipal Income
PNFP	Pinnacle Financial Partners Inc.
PNI	Pimco New York Municipal Income
PNK	Pinnacle Entertainment Inc.
PNM	PNM Resources
PNNT	PennantPark Investment Corporation
PNQI	PowerShares NASDAQ Internet
PNR	Pentair plc
PNRA	Panera Bread Company
PNRG	PrimeEnergy Corp.
PNTR	Pointer Telocation Ltd.
PNW	Pinnacle West Capital Corporation
PNX	The Phoenix Companies Inc.
PNY	Piedmont Natural Gas Co. Inc.
PODD	Insulet Corporation
POL	PolyOne Corporation
POM	Pepco Holdings
POOL	Pool Corp.
POPE	Pope Resources
POR	Portland General Electric Company
POST	Post Holdings
POT	Potash Corp. of Saskatchewan
POWI	Power Integrations Inc.
POWL	Powell Industries
POWR	PowerSecure International
POZN	POZEN Inc.
PPA	PowerShares Aerospace & Defense ETF
PPBI	Pacific Premier Bancorp Inc.
PPC	Pilgrim's Pride Corporation
PPG	PPG Industries Inc.
PPH	Market Vectors Pharmaceutical ETF
PPHM	Peregrine Pharmaceuticals
PPL	PPL Corporation
PPLT	ETFS Physical Platinum Shares
PPO	Polypore International Inc.
PPP	Primero Mining Corp.
PPR	ING Prime Rate Trust
PPS	Post Properties Inc.
PPT	Putnam Premier Income Trust
PQ	PetroQuest Energy Inc.
PRA	ProAssurance Corporation
PRAA	Portfolio Recovery Associates Inc.
PRAN	Prana Biotechnology Limited
PRB	Market Vectors Pre-Refunded Muni ETF
PRCP	Perceptron
PRE	PartnerRe Ltd.
PRF	PowerShares FTSE RAFI US 1000 ETF
PRFT	Perficient Inc.
PRFZ	PowerShares FTSE RAFI US 1500 Sm-Mid ETF
PRGN	Paragon Shipping Inc.
PRGO	Perrigo Company Public Limited Company
PRGS	Progress Software Corporation
PRGX	PRGX Global
PRI	Primerica
PRIM	Primoris Services Corporation
PRIS	Promotora de Informaciones
PRK	Park National Corp.
PRKR	Parkervision Inc.
PRLB	Proto Labs
PRLS	Peerless Systems Corp.
PRMW	Primo Water Corporation
PRN	PowerShares DWA Industrials Momentum ETF
PRO	PROS Holdings
PROV	Provident Financial Holdings
PRPH	ProPhase Labs
PRSC	Providence Service Corp.
PRSS	CafePress Inc.
PRTA	Prothena Corporation plc
PRTS	U.S. Auto Parts Network
PRU	Prudential Financial
PRXI	Premier Exhibitions Inc.
PRXL	PAREXEL International Corporation
PSA	Public Storage
PSAU	PowerShares Global Gold & Prec Mtls ETF
PSB	PS Business Parks Inc.
PSBH	PSB Holdings Inc.
PSCC	PowerShares S&P SmallCap Cnsmr Stapl ETF
PSCD	PowerShares S&P SmCap Cnsmr Discret ETF
PSCE	PowerShares S&P SmallCap Energy ETF
PSCF	PowerShares S&P SmallCap Financials ETF
PSCH	PowerShares S&P SmallCap Health Care ETF
PSCI	PowerShares S&P SmallCap Industrials ETF
PSCM	PowerShares S&P SmallCap Materials ETF
PSCT	PowerShares S&P SmallCap Info Tech ETF
PSCU	PowerShares S&P SmallCap Utilities ETF
PSDV	pSivida Corp.
PSEC	Prospect Capital Corporation
PSEM	Pericom Semiconductor Corp.
PSI	PowerShares Dynamic Semiconductors ETF
PSIX	Power Solutions International
PSJ	PowerShares Dynamic Software ETF
PSK	SPDR Wells Fargo Preferred Stock ETF
PSL	PowerShares DWA Consumer Staples Mom ETF
PSMI	Peregrine Semiconductor Corporation
PSMT	PriceSmart Inc.
PSO	Pearson plc
PSP	PowerShares Global Listed Private Eq ETF
PSQ	ProShares Short QQQ
PSR	PowerShares Active US Real Estate ETF
PST	ProShares UltraShort 7-10 Year Treasury
PSTB	Park Sterling Corporation
PSTI	Pluristem Therapeutics
PSTR	PostRock Energy Corporation
PSUN	Pacific Sunwear of California Inc.
PSX	Phillips 66
PSXP	Phillips 66 Partners LP
PT	Portugal Telecom
PTC	PTC Inc.
PTCT	PTC Therapeutics
PTEK	PokerTek
PTEN	Patterson-UTI Energy Inc.
PTF	PowerShares DWA Technology Momentum ETF
PTH	PowerShares DWA Healthcare Momentum ETF
PTIE	Pain Therapeutics Inc.
PTLA	Portola Pharmaceuticals
PTM	UBS E-TRACS Long Platinum TR ETN
PTN	Palatin Technologies Inc.
PTNR	Partner Communications Company Ltd.
PTNT	Internet Patents Corporation
PTP	Platinum Underwriters Holdings Ltd.
PTR	PetroChina Co. Ltd.
PTRY	The Pantry
PTSI	P.A.M. Transportation Services
PTSX	Point.360
PTX	Pernix Therapeutics Holdings
PTY	PIMCO Corporate Opportunity Fund
PUI	PowerShares DWA Utilities Momentum ETF
PUK	Prudential plc
PULB	Pulaski Financial Corporation
PULS	Pulse Electronics Corporation
PUW	PowerShares WilderHill Prog Engy ETF
PVA	Penn Virginia Corporation
PVCT	Provectus Biopharmaceuticals
PVD	Administradora de Fondos de Pensiones Provida S.A.
PVG	Pretium Resources Inc.
PVH	PVH Corp.
PVI	PowerShares VRDO Tax-Free Weekly ETF
PVTB	PrivateBancorp
PW	Power REIT
PWB	PowerShares Dynamic Large Cap Growth ETF
PWC	PowerShares Dynamic Market ETF
PWE	Penn West Petroleum Ltd.
PWO	PowerShares Dynamic OTC
PWOD	Penns Woods Bancorp Inc.
PWR	Quanta Services
PWRD	Perfect World Co.
PWV	PowerShares Dynamic Large Cap Value ETF
PWX	Providence and Worcester Railroad Company
PWZ	PowerShares Calif AMT-Free Muni Bd ETF
PX	Praxair Inc.
PXD	Pioneer Natural Resources Co.
PXE	PowerShares Dynamic Engy Explr&Prdtn ETF
PXF	PowerShares FTSE RAFI Dev Mkts ex-US ETF
PXH	PowerShares FTSE RAFI Emerging Mkts ETF
PXI	PowerShares DWA Energy Momentum ETF
PXJ	PowerShares Dynamic Oil & Gas Svcs ETF
PXLC	PowerShares Fundamental Pure Lg Core ETF
PXLG	PowerShares Fundamental Pure Lg Gr ETF
PXLV	PowerShares Fundamental Pure Lg Val ETF
PXLW	Pixelworks
PXMC	PowerShares Fundamental Pure Md Core ETF
PXMG	PowerShares Fundamental Pure Mid Gr ETF
PXMV	PowerShares Fundamental Pure Mid Val ETF
PXQ	PowerShares Dynamic Networking ETF
PXR	PowerShares Emerging Markets Infras ETF
PXSC	PowerShares Fundamental Pure Sm Core ETF
PXSG	PowerShares Fundamental Pure Sm Gr ETF
PXSV	PowerShares Fundamental Pure Sm Val ETF
PYN	PIMCO New York Municipal Income
PYZ	PowerShares DWA Basic Materials Mom ETF
PZA	PowerShares National AMT-Free MuniBd ETF
PZC	PIMCO California Municipal Inco
PZD	PowerShares Cleantech ETF
PZE	Petrobras Argentina SA
PZG	Paramount Gold and Silver Corp.
PZI	PowerShares Zacks Micro Cap ETF
PZN	Pzena Investment Management
PZT	PowerShares New York AMT-Free MuniBd ETF
PZZA	Papa John's International Inc.
PZZI	Pizza Inn Holdings
Q	Quintiles Transnational Holdings Inc.
QABA	First Trust NASDAQ ABA Community Bank
QADA	QAD Inc.
QAI	IQ Hedge Multi-Strategy Tracker ETF
QAT	iShares MSCI Qatar Capped
QAUS	SPDR MSCI Australia Quality Mix ETF
QBAK	Qualstar Corp.
QCCO	QC Holdings
QCLN	First Trust NASDAQ Cln Edg Green En Idx
QCOM	QUALCOMM Incorporated
QCOR	Questcor Pharmaceuticals
QCRH	QCR Holdings Inc.
QDEF	FlexShares Quality Dividend Defensive
QDEL	Quidel Corp.
QDEM	Market Vectors MSCI EM Quality Div ETF
QDEU	SPDR MSCI Germany Quality Mix ETF
QDF	FlexShares Quality Dividend
QDXU	Market Vectors MSCI Intl Qual Div ETF
QDYN	FlexShares Quality Dividend Dynamic
QEFA	SPDR MSCI EAFE Quality Mix ETF
QEH	AdvisorShares QAM Equity Hedge ETF
QEM	Market Vectors MSCI EM Quality ETF
QEMM	SPDR MSCI Emerging Markets Qual Mix ETF
QEP	QEP Resources
QEPM	QEP Midstream Partners
QESP	SPDR MSCI Spain Quality Mix ETF
QGEN	Qiagen NV
QID	ProShares UltraShort QQQ
QIHU	Qihoo 360 Technology Co. Ltd.
QIWI	Qiwi plc
QJPN	SPDR MSCI Japan Quality Mix ETF
QKLS	QKL Stores Inc.
QLD	ProShares Ultra QQQ
QLGC	QLogic Corp.
QLIK	Qlik Technologies
QLTA	iShares Aaa - A Rated Corporate Bond
QLTB	iShares Baa - Ba Rated Corporate Bond
QLTC	iShares B - Ca Rated Corporate Bond
QLTI	QLT Inc.
QLTY	Quality Distribution Inc.
QLYS	Qualys
QMN	IQ Hedge Market Neutral Tracker ETF
QNST	QuinStreet
QQEW	First Trust NASDAQ-100 Equal Weight Idx
QQQ	PowerShares QQQ
QQQC	Global X NASDAQ China Technology ETF
QQQE	Direxion NASDAQ-100 Equal Wtd Idx Shrs
QQQX	NASDAQ Premium Income and Growt
QQXT	First Trust NASDAQ-100 ex-Tech Sec Idx
QRE	QR Energy
QRM	Quest Rare Minerals Ltd.
QSII	Quality Systems Inc.
QTEC	First Trust NASDAQ-100-Tech Index
QTM	Quantum Corporation
QTS	QTS Realty Trust
QTWO	Q2 Holdings
QTWW	Quantum Fuel Systems Technologies Worldwide Inc.
QUAD	Quad/Graphics
QUIK	QuickLogic Corporation
QUMU	Qumu Corporation
QUNR	Qunar Cayman Islands Limited
QURE	uniQure N.V.
QWLD	SPDR MSCI World Quality Mix ETF
QXUS	Market Vectors MSCI Intl Quality ETF
QYLD	Recon Capital NASDAQ 100 Cov Call ETF
R	Ryder System
RAD	Rite Aid Corporation
RADA	RADA Electronic Industries Ltd.
RAI	Reynolds American Inc.
RAIL	FreightCar America Inc.
RALS	ProShares RAFI Long/Short
RALY	Rally Software Development Corp.
RAND	Rand Capital Corporation
RARE	Ultragenyx Pharmaceutical Inc.
RAS	RAIT Financial Trust
RATE	Bankrate
RAVI	FlexShares Ready Access Variable Inc
RAVN	Raven Industries Inc.
RAX	Rackspace Hosting
RBA	Ritchie Bros. Auctioneers Incorporated
RBC	Regal Beloit Corporation
RBCAA	Republic Bancorp Inc.
RBCN	Rubicon Technology
RBL	SPDR S&P Russia
RBPAA	Royal Bancshares of Pennsylvania Inc.
RBS	The Royal Bank of Scotland Group plc
RBY	Rubicon Minerals Corporation
RCAP	RCS Capital Corporation
RCD	Rydex S&P Equal Weight Consumer Disc
RCG	RENN Global Entrepreneurs Fund
RCI	Rogers Communications Inc.
RCII	Rent-A-Center
RCKY	Rocky Brands
RCL	Royal Caribbean Cruises Ltd.
RCMT	RCM Technologies Inc.
RCON	Recon Technology
RCPI	Rock Creek Pharmaceuticals
RCPT	Receptos
RCS	PIMCO Strategic Global Government Fund Inc.
RDC	Rowan Companies plc
RDCM	Radcom Ltd.
RDEN	Elizabeth Arden
RDI	Reading International
RDIV	RevenueShares Ultra Dividend ETF
RDN	Radian Group Inc.
RDNT	RadNet
RDS-B	Royal Dutch Shell plc
RDVY	First Trust NASDAQ Rising Div Achiev ETF
RDWR	Radware Ltd.
RDY	Dr. Reddy's Laboratories Ltd.
RE	Everest Re Group Ltd.
RECN	Resources Connection Inc.
REDF	Rediff.com India Limited
REE	Rare Element Resources Ltd.
REED	REEDS
REET	iShares Global REIT
REFR	Research Frontiers Inc.
REG	Regency Centers Corporation
REGI	Renewable Energy Group
REGN	Regeneron Pharmaceuticals
REI	Ring Energy
REIS	Reis
REK	ProShares Short Real Estate
RELL	Richardson Electronics Ltd.
RELV	Reliv International
REM	iShares Mortgage Real Estate Capped
REMX	Market Vectors Rare EarthStrat Mtls ETF
REMY	Remy International
REN	Resolute Energy Corporation
RENN	Renren Inc.
RENT	Rentrak Corporation
REPH	Recro Pharma
RES	RPC Inc.
RESI	Altisource Residential Corporation
RESN	Resonant Inc.
RETL	Direxion Daily Retail Bull 3X Shares
REV	Revlon
REW	ProShares UltraShort Technology
REX	REX American Resources Corporation
REXI	Resource America
REXR	Rexford Industrial Realty
REXX	Rex Energy Corporation
REZ	iShares Residential Rel Est Capped
RF	Regions Financial Corporation
RFG	Guggenheim S&P MidCap 400 Pure Gr ETF
RFI	Cohen & Steers Total Return Realty Fund Inc.
RFIL	RF Industries
RFMD	RF Micro Devices Inc.
RFP	Resolute Forest Products Inc.
RFV	Rydex S&P Midcap 400 Pure Value
RGA	Reinsurance Group of America Inc.
RGC	Regal Entertainment Group
RGCO	RGC Resources
RGDX	Response Genetics
RGEN	Repligen Corporation
RGI	Rydex S&P Equal Weight Industrials
RGLD	Royal Gold
RGLS	Regulus Therapeutics Inc.
RGP	Regency Energy Partners LP
RGR	Sturm
RGS	Regis Corp.
RGSE	Real Goods Solar
RH	Restoration Hardware Holdings
RHI	Robert Half International Inc.
RHP	Ryman Hospitality Properties
RHS	Rydex S&P Equal Weight Consumer Staples
RHT	Red Hat
RIBT	RiceBran Technologies
RIC	Richmont Mines Inc.
RICE	Rice Energy Inc.
RICK	RCI Hospitality Holdings
RIF	RMR Real Estate Income Fund
RIG	Transocean Ltd.
RIGL	Rigel Pharmaceuticals
RIGS	ALPS RiverFront Strategic Income
RINF	ProShares 30 Year TIPS/TSY Spread
RING	iShares MSCI Global Gold Miners
RIO	Rio Tinto plc
RIOM	Rio Alto Mining Limited
RIT	LMP Real Estate Income Fund Inc
RITT	RiT Technologies Ltd.
RIVR	River Valley Bancorp
RJA	ELEMENTS Rogers Intl Commodity Agri ETN
RJET	Republic Airways Holdings Inc.
RJF	Raymond James Financial
RJI	ELEMENTS Rogers Intl Commodity ETN
RJN	ELEMENTS Rogers Intl Commodity Engy ETN
RJZ	ELEMENTS Rogers Intl Commodity Metal ETN
RKH	Market Vectors Bank and Brokerage ETF
RKT	Rock-Tenn Company
RKUS	Ruckus Wireless
RL	Ralph Lauren Corporation
RLD	RealD Inc.
RLGT	Radiant Logistics
RLGY	Realogy Holdings Corp.
RLH	Red Lion Hotels Corporation
RLI	RLI Corp.
RLJ	RLJ Lodging Trust
RLJE	RLJ Entertainment
RLOC	ReachLocal
RLOG	Rand Logistics
RLY	SPDR SSgA Multi-Asset Real Return ETF
RLYP	Relypsa
RM	Regional Management Corp.
RMAX	RE/MAX Holdings
RMBS	Rambus Inc.
RMCF	Rocky Mountain Chocolate Factory Inc.
RMD	ResMed Inc.
RMGN	RMG Networks Holding Corporation
RMT	Royce Micro-Cap Trust
RMTI	Rockwell Medical
RNA	Prosensa Holding N.V.
RNDY	Roundy's
RNE	Morgan Stanley Eastern Europe Fund Inc
RNET	RigNet
RNF	Rentech Nitrogen Partners
RNG	RingCentral
RNN	Rexahn Pharmaceuticals
RNO	Rhino Resource Partners LP
RNP	Cohen & Steers REIT & Preferred Income Fund Inc.
RNR	RenaissanceRe Holdings Ltd.
RNST	Renasant Corp.
RNWK	RealNetworks Inc.
ROC	Rockwood Holdings
ROCK	Gibraltar Industries
ROG	Rogers Corporation
ROIA	Radio One Inc.
ROIAK	Radio One Inc.
ROIC	Retail Opportunity Investments Corp.
ROIQ	ROI Acquisition Corp. II
ROK	Rockwell Automation Inc.
ROL	Rollins Inc.
ROLL	RBC Bearings Inc.
ROM	ProShares Ultra Technology
ROOF	IQ U.S. Real Estate Small Cap ETF
ROP	Roper Industries Inc.
ROSE	Rosetta Resources
ROSG	Rosetta Genomics
ROST	Ross Stores Inc.
ROVI	Rovi Corporation
ROX	Castle Brands Inc.
ROYL	Royale Energy Inc.
ROYT	Pacific Coast Oil Trust
RP	RealPage
RPAI	Retail Properties of America
RPG	Guggenheim S&P 500 Pure Growth ETF
RPI	Roberts Realty Investors Inc.
RPM	RPM International Inc.
RPRX	Repros Therapeutics Inc.
RPT	Ramco-Gershenson Properties Trust
RPTP	Raptor Pharmaceuticals Corp.
RPV	Guggenheim S&P 500 Pure Value ETF
RPX	Columbia Large Cap Growth ETF
RPXC	RPX Corporation
RQI	Cohen & Steers Quality Income Realty Fund Inc.
RRC	Range Resources Corporation
RRD	R.R. Donnelley & Sons Company
RRF	WisdomTree Global Real Return
RRGB	Red Robin Gourmet Burgers Inc.
RRMS	Rose Rock Midstream
RRST	RRSat Global Communications Network Ltd.
RRTS	Roadrunner Transportation Systems
RS	Reliance Steel & Aluminum Co.
RSCO	SPDR Russell Small Cap Completeness
RSE	Rouse Properties
RSG	Republic Services
RSH	RadioShack Corp.
RSO	Resource Capital Corp.
RSP	Guggenheim S&P 500 Equal Weight ETF
RSPP	RSP Permian
RST	Rosetta Stone
RSTI	Rofin-Sinar Technologies Inc.
RSX	Market Vectors Russia ETF
RSXJ	Market Vectors Russia Small-Cap ETF
RSYS	RadiSys Corporation
RT	Ruby Tuesday
RTEC	Rudolph Technologies Inc.
RTGN	Ruthigen
RTH	Market Vectors Retail ETF
RTI	RTI International Metals
RTIX	RTI Surgical Inc.
RTK	Rentech
RTL	iShares Retail Real Estate Capped
RTM	Guggenheim S&P 500 Eq Wt Materials ETF
RTN	Raytheon Co.
RTR	RevenueShares ADR ETF
RTRX	Retrophin
RUBI	the Rubicon Project
RUDR	VelocityShares Russia Select DR ETF
RUK	Reed Elsevier plc
RUSHB	Rush Enterprises
RUSL	Direxion Daily Russia Bull 3X Shares
RUSS	Direxion Daily Russia Bear 3X Shares
RUTH	Ruth's Hospitality Group Inc.
RVBD	Riverbed Technology
RVLT	Revolution Lighting Technologies
RVM	Revett Mining Company
RVNC	Revance Therapeutics
RVNU	Deutsche X-trackers Muni Infras Revn Bd
RVP	Retractable Technologies
RVSB	Riverview Bancorp Inc.
RVT	Royce Value Trust Inc.
RWC	RELM Wireless Corp.
RWG	Columbia Lg Cap Growth Equity Strat Fund
RWJ	RevenueShares Small Cap ETF
RWK	RevenueShares Mid Cap ETF
RWL	RevenueShares Large Cap ETF
RWM	ProShares Short Russell2000
RWO	SPDR Dow Jones Global Real Estate
RWR	SPDR Dow Jones REIT ETF
RWT	Redwood Trust
RWV	RevenueShares NavellierOverall A-100 ETF
RWW	RevenueShares Financials Sector ETF
RWX	SPDR Dow Jones Intl Real Estate
RWXL	UBS E-TRACS Mo Pay 2x DJ Intl Rl Est ETN
RXD	ProShares UltraShort Health Care
RXDX	Ignyta
RXI	iShares Globl Consumer Discretionary
RXII	RXi Pharmaceuticals Corporation
RXL	ProShares Ultra Health Care
RXN	Rexnord Corporation
RY	Royal Bank of Canada
RYAAY	Ryanair Holdings plc
RYE	Guggenheim S&P 500 Equal Wt Energy ETF
RYF	Guggenheim S&P 500 Eq Weight Fincl ETF
RYH	Guggenheim S&P 500 Eq Weight HC ETF
RYJ	Guggenheim Raymond James SB-1 Equity ETF
RYL	Ryland Group Inc.
RYN	Rayonier Inc.
RYT	Guggenheim S&P 500 Eq Wt Technology ETF
RYU	Guggenheim S&P 500 Eq Wt Utilities ETF
RZG	Guggenheim S&P SmallCap 600 Pure Gr ETF
RZV	Guggenheim S&P SmallCap 600 PureVal ETF
S	Sprint Corporation
SA	Seabridge Gold
SAA	ProShares Ultra SmallCap600
SAAS	inContact
SABA	Saba Software
SABR	Sabre Corporation
SAEX	SAExploration Holdings
SAFM	Sanderson Farms
SAFT	Safety Insurance Group Inc.
SAGE	Sage Therapeutics
SAGG	Direxion Daily Tot Bd Mkt Bear 1X Shares
SAH	Sonic Automotive Inc.
SAIA	Saia
SAIC	Science Applications International Corporation
SAL	Salisbury Bancorp Inc.
SALE	RetailMeNot
SALM	Salem Communications Corp.
SALT	Scorpio Bulkers Inc.
SAM	Boston Beer Co. Inc.
SAN	Banco Santander
SAND	Sandstorm Gold Ltd.
SANM	Sanmina Corporation
SANW	S&W Seed Company
SAP	SAP SE
SAPE	Sapient Corp.
SAR	Saratoga Investment Corp.
SARA	Saratoga Resources Inc.
SASR	Sandy Spring Bancorp Inc.
SATS	EchoStar Corp.
SAVE	Spirit Airlines
SB	Safe Bulkers
SBAC	SBA Communications Corp.
SBB	ProShares Short SmallCap600
SBBX	Sussex Bancorp
SBCF	Seacoast Banking Corp. of Florida
SBFG	SB Financial Group
SBGI	Sinclair Broadcast Group
SBGL	Sibanye Gold Limited
SBH	Sally Beauty Holdings Inc.
SBI	Western Asset Intermediate Muni Fund Inc.
SBLK	Star Bulk Carriers Corp.
SBM	ProShares Short Basic Materials
SBND	PowerShares DB 3x Shrt 25+Yr Trsy Bd ETN
SBNY	Signature Bank
SBR	Sabine Royalty Trust
SBRA	Sabra Health Care REIT
SBS	Companhia de Saneamento Basico do Estado de Sao Paulo
SBSA	Spanish Broadcasting System Inc.
SBSI	Southside Bancshares Inc.
SBUX	Starbucks Corporation
SBV	iPath Pure Beta S&P GSCI-Weighted ETN
SBW	Western Asset Worldwide Income Fund Inc.
SBY	Silver Bay Realty Trust Corp.
SC	Santander Consumer USA Holdings Inc.
SCC	ProShares UltraShort Consumer Services
SCCO	Southern Copper Corp.
SCD	LMP Capital and Income Fund Inc
SCG	SCANA Corp.
SCHA	Schwab US Small-Cap ETF
SCHB	Schwab US Broad Market ETF
SCHC	Schwab International Small-Cap Eq ETF
SCHE	Schwab Emerging Markets Equity ETF
SCHF	Schwab International Equity ETF
SCHG	Schwab US Large-Cap Growth ETF
SCHL	Scholastic Corporation
SCHN	Schnitzer Steel Industries
SCHO	Schwab Short-Term US Treasury ETF
SCHP	Schwab US TIPS ETF
SCHR	Schwab Intermediate-Term US Trs ETF
SCHV	Schwab US Large-Cap Value ETF
SCHW	The Charles Schwab Corporation
SCHX	Schwab US Large-Cap ETF
SCHZ	Schwab US Aggregate Bond ETF
SCI	Service Corporation International
SCIF	Market Vectors India Small-Cap ETF
SCIN	EGShares India Small Cap
SCJ	iShares MSCI Japan Small-Cap
SCL	Stepan Company
SCLN	SciClone Pharmaceuticals
SCMP	Sucampo Pharmaceuticals
SCO	ProShares UltraShort Bloomberg Crude Oil
SCOK	SinoCoking Coal and Coke Chemical Industries
SCON	Superconductor Technologies Inc.
SCOR	comScore
SCPB	SPDR Barclays Capital Short Term Corp Bd
SCS	Steelcase Inc.
SCSC	ScanSource
SCSS	Select Comfort Corporation
SCTY	SolarCity Corporation
SCVL	Shoe Carnival Inc.
SCX	The L.S. Starrett Company
SCYX	SCYNEXIS
SCZ	iShares MSCI EAFE Small-Cap
SD	SandRidge Energy
SDD	ProShares UltraShort SmallCap600
SDIV	Global X SuperDividend ETF
SDK	ProShares UltraShort Russell MCap Growth
SDLP	Seadrill Partners LLC
SDOG	ALPS Sector Dividend Dogs ETF
SDOW	ProShares UltraPro Short Dow30
SDP	ProShares UltraShort Utilities
SDPI	Superior Drilling Products
SDR	Sandridge Mississippian Trust II
SDRL	SeaDrill Limited
SDS	ProShares UltraShort S&P500
SDT	SandRidge Mississippian Trust I
SDY	SPDR S&P Dividend ETF
SDYL	UBS E-TRACS Mo Pay 2x S&P Dividend ETN
SE	Spectra Energy Corp.
SEA	Claymore/Delta Global Shipping
SEAC	SeaChange International Inc.
SEAS	SeaWorld Entertainment
SEB	Seaboard Corp.
SEE	Sealed Air Corporation
SEED	Origin Agritech Limited
SEF	ProShares Short Financials
SEIC	SEI Investments Co.
SEM	Select Medical Holdings Corporation
SEMG	SemGroup Corporation
SEMI	SunEdison Semiconductor Limited
SENEA	Seneca Foods Corp.
SENEB	Seneca Foods Corp.
SEP	Spectra Energy Partners
SERV	ServiceMaster Global Holdings
SEV	Sevcon
SF	Stifel Financial Corp.
SFBC	Sound Financial Bancorp
SFBS	ServisFirst Bancshares
SFE	Safeguard Scientifics
SFG	StanCorp Financial Group Inc.
SFK	ProShares UltraShort Russell1000 Growth
SFL	Ship Finance International Limited
SFLA	iPath Long Extended S&P 500 TR ETN
SFLY	Shutterfly
SFM	Sprouts Farmers Market
SFN	Stifel Financial Corp.
SFNC	Simmons First National Corporation
SFST	Southern First Bancshares
SFUN	SouFun Holdings Ltd.
SFXE	SFX Entertainment Inc.
SFY	Swift Energy Co.
SGA	Saga Communications Inc.
SGAR	iPath Pure Beta Sugar ETN
SGB	Southwest Georgia Financial Corp.
SGBK	Stonegate Bank
SGC	Superior Uniform Group Inc.
SGEN	Seattle Genetics Inc.
SGF	Aberdeen Singapore Fund
SGG	iPath DJ-UBS Sugar TR Sub-Idx ETN
SGI	Silicon Graphics International Corp.
SGL	Strategic Global Income Fund
SGM	Stonegate Mortgage Corporation
SGMA	SigmaTron International Inc.
SGMO	Sangamo Biosciences Inc.
SGMS	Scientific Games Corporation
SGNL	Signal Genetics
SGNT	Sagent Pharmaceuticals
SGOC	SGOCO Group
SGOL	ETFS Physical Swiss Gold Shares
SGRP	Spar Group Inc.
SGU	Star Gas Partners
SGY	Stone Energy Corp.
SGYP	Synergy Pharmaceuticals
SH	ProShares Short S&P500
SHBI	Shore Bancshares
SHEN	Shenandoah Telecommunications Co.
SHG	Shinhan Financial Group Company Limited
SHI	Sinopec Shanghai Petrochemical Co. Ltd.
SHIP	Seanergy Maritime Holdings Corp.
SHLD	Sears Holdings Corporation
SHLM	A. Schulman
SHLO	Shiloh Industries Inc.
SHM	SPDR Nuveen Barclays Capital S/T Muni Bd
SHO	Sunstone Hotel Investors Inc.
SHOO	Steven Madden
SHOR	ShoreTel
SHOS	Sears Hometown and Outlet Stores
SHV	iShares Short Treasury Bond
SHW	The Sherwin-Williams Company
SHY	iShares 1-3 Year Treasury Bond
SHYD	Market Vectors Short Hi-Yld Muni ETF
SIAL	Sigma-Aldrich Corporation
SIBC	State Investors Bancorp
SID	Companhia Siderurgica Nacional
SIEB	Siebert Financial Corp.
SIF	SIFCO Industries Inc.
SIFI	SI Financial Group Inc.
SIFY	Sify Technologies Limited
SIG	Signet Jewelers Limited
SIGA	SIGA Technologies
SIGI	Selective Insurance Group Inc.
SIGM	Sigma Designs
SIJ	ProShares UltraShort Industrials
SIL	Global X Silver Miners ETF
SILC	Silicom Ltd.
SILJ	PureFunds ISE Junior Silver ETF
SIM	Grupo Simec S.A.B. de C.V.
SIMG	Silicon Image
SIMO	Silicon Motion Technology Corp.
SINA	SINA Corporation
SINO	Sino-Global Shipping America
SIR	Select Income REIT Common Share
SIRI	Sirius XM Holdings Inc.
SIRO	Sirona Dental Systems Inc.
SIVB	SVB Financial Group
SIVR	ETFS Physical Silver Shares
SIX	Six Flags Entertainment Corporation
SIZ	QuantShares US Market Neutral Size ETF
SIZE	iShares MSCI USA Size Factor
SJH	ProShares UltraShort Russell2000 Value
SJI	South Jersey Industries
SJM	The J. M. Smucker Company
SJNK	SPDR BarCap ST High Yield Bond ETF
SJR	Shaw Communications
SJT	San Juan Basin Royalty Trust
SJW	SJW Corp.
SKBI	Skystar Bio Pharmaceutical Company
SKF	ProShares UltraShort Financials
SKH	Skilled Healthcare Group
SKK	ProShares UltraShort Russell2000 Growth
SKM	SK Telecom Co. Ltd.
SKT	Tanger Factory Outlet Centers Inc.
SKUL	Skullcandy
SKX	Skechers USA Inc.
SKY	Skyline Corp.
SKYW	SkyWest Inc.
SKYY	First Trust ISE Cloud Computing Index
SLA	American Select Portfolio Inc.
SLAB	Silicon Laboratories Inc.
SLB	Schlumberger Limited
SLCA	U.S. Silica Holdings
SLF	Sun Life Financial Inc.
SLG	SL Green Realty Corp.
SLGN	Silgan Holdings Inc.
SLH	Solera Holdings Inc.
SLI	SL Industries Inc.
SLM	SLM Corporation
SLP	Simulations Plus
SLRC	Solar Capital Ltd.
SLTC	Selectica
SLV	iShares Silver Trust
SLVO	Credit Suisse Silver Shares Cov Call ETN
SLVP	iShares MSCI Global Silver Miners
SLW	Silver Wheaton Corp.
SLX	Market Vectors Steel ETF
SLXP	Salix Pharmaceuticals Ltd.
SLY	SPDR S&P 600 Small Cap ETF
SLYG	SPDR S&P 600 Small Cap Growth ETF
SLYV	SPDR S&P 600 Small Cap Value ETF
SM	SM Energy Company
SMA	Symmetry Medical
SMB	Market Vectors Short Municipal ETF
SMBC	Southern Missouri Bancorp
SMCI	Super Micro Computer
SMDD	ProShares UltraPro Short MidCap400
SMED	Sharps Compliance Corp.
SMEZ	SPDR EURO STOXX Small Cap ETF
SMFG	Sumitomo Mitsui Financial Group
SMG	The Scotts Miracle-Gro Company
SMH	Market Vectors Semiconductor ETF
SMI	Semiconductor Manufacturing International Corp.
SMIN	iShares MSCI India Small-Cap
SMIT	Schmitt Industries
SMLP	Summit Midstream Partners
SMLR	Semler Scientific Inc
SMLV	SPDR Russell 2000 Low Volatility ETF
SMMF	Summit Financial Group Inc.
SMMU	PIMCO Short Term Municipal Bond ETF
SMN	ProShares UltraShort Basic Materials
SMP	Standard Motor Products Inc.
SMPL	Simplicity Bancorp
SMRT	Stein Mart Inc.
SMSI	Smith Micro Software Inc.
SMTC	Semtech Corporation
SMTP	SMTP
SMTX	SMTC Corporation
SN	Sanchez Energy Corporation
SNA	Snap-on Incorporated
SNAK	Inventure Foods
SNBC	Sun Bancorp Inc.
SNCR	Synchronoss Technologies
SNDK	SanDisk Corp.
SNE	Sony Corporation
SNFCA	Security National Financial Corp.
SNH	Senior Housing Properties Trust
SNHY	Sun Hydraulics Corp.
SNI	Scripps Networks Interactive
SNLN	Highland/iBoxx Senior Loan ETF
SNMX	Senomyx Inc.
SNN	Smith & Nephew plc
SNOW	Intrawest Resorts Holdings
SNP	China Petroleum & Chemical Corp.
SNPS	Synopsys Inc.
SNSS	Sunesis Pharmaceuticals
SNTA	Synta Pharmaceuticals Corp.
SNV	Synovus Financial Corporation
SNX	SYNNEX Corp.
SNY	Sanofi
SO	Southern Company
SOCB	Southcoast Financial Corp.
SOCL	Global X Social Media Index ETF
SODA	SodaStream International Ltd.
SOFO	Sonic Foundry
SOHO	Sotherly Hotels Inc.
SOHU	Sohu.com Inc.
SOIL	Global X Fertilizers/Potash ETF
SOL	ReneSola Ltd.
SON	Sonoco Products Co.
SONA	Southern National Bancorp of Virginia Inc.
SONC	Sonic Corp.
SONS	Sonus Networks
SOQ	Sonde Resources Corp.
SOR	Sora Capital Corp.
SORL	SORL Auto Parts
SOXL	Direxion Daily Semicondct Bull 3X Shares
SOXS	Direxion Daily Semicondct Bear 3X Shares
SOXX	iShares PHLX SOX Semiconductor Sector
SOYB	Teucrium Soybean ETF
SPA	Sparton Corp.
SPAN	Span-America Medical Systems Inc.
SPAR	Spartan Motors Inc.
SPB	Spectrum Brands Holdings
SPBC	SP Bancorp
SPCB	SuperCom Ltd.
SPCHB	Sport Chalet Inc.
SPDC	Speed Commerce
SPE	Special Opportunities Fund
SPEX	Spherix Incorporated
SPF	Standard Pacific Corp.
SPG	Simon Property Group Inc.
SPGH	UBS E-TRACS S&P 500 Gold Hedged Idx ETN
SPH	Suburban Propane Partners
SPHB	PowerShares S&P 500 High Beta ETF
SPHQ	PowerShares S&P 500 High Quality ETF
SPHS	Sophiris Bio
SPIL	Siliconware Precision Industries Co. Ltd.
SPLK	Splunk
SPLP	Steel Partners Holdings L.P
SPLS	Staples
SPLV	PowerShares S&P 500 Low Volatility ETF
SPN	Superior Energy Services
SPNC	The Spectranetics Corporation
SPNS	Sapiens International Corporation N.V.
SPPI	Spectrum Pharmaceuticals
SPPR	Supertel Hospitality
SPR	Spirit AeroSystems Holdings
SPRO	SmartPros Ltd.
SPRT	Support.com
SPSC	SPS Commerce
SPTN	SpartanNash Company
SPU	SkyPeople Fruit Juice
SPUU	Direxion Daily S&P 500 Bull 2X Shares
SPW	SPX Corporation
SPWH	Sportsman's Warehouse Holdings
SPWR	SunPower Corporation
SPXH	VelocityShares Volatility Hdgd Lg Cp ETF
SPXL	Direxion Daily S&P500 Bull 3X Shares
SPXS	Direxion Daily S&P500 Bear 3X Shares
SPXU	ProShares UltraPro Short S&P500
SPY	SPDR S&P 500
SPYG	SPDR S&P 500 Growth ETF
SPYV	SPDR S&P 500 Value ETF
SQBG	Sequential Brands Group
SQBK	Square 1 Financial
SQI	SciQuest
SQM	Chemical & Mining Co. of Chile Inc.
SQNM	Sequenom Inc.
SQNS	Sequans Communications S.A.
SQQQ	ProShares UltraPro Short QQQ
SR	The Standard Register Company
SRC	Spirit Realty Capital
SRCE	1st Source Corporation
SRCL	Stericycle
SRDX	SurModics
SRE	Sempra Energy
SREV	ServiceSource International
SRI	Stoneridge Inc.
SRLN	SPDR Blackstone/GSO Senior Loan ETF
SRLP	Sprague Resources LP
SRNE	Sorrento Therapeutics
SRPT	Sarepta Therapeutics
SRS	ProShares UltraShort Real Estate
SRT	StarTek
SRTY	ProShares UltraPro Short Russell2000
SRV	The Cushing MLP Total Return Fu
SSB	South State Corporation
SSBI	Summit State Bank
SSD	Simpson Manufacturing Co.
SSE	Seventy Seven Energy Inc.
SSFN	Stewardship Financial Corp.
SSG	ProShares UltraShort Semiconductors
SSH	Sunshine Heart Inc.
SSI	Stage Stores Inc.
SSL	Sasol Ltd.
SSLT	Sesa Sterlite Limited
SSN	Samson Oil & Gas Limited
SSNC	SS&C Technologies Holdings
SSNI	Silver Spring Networks
SSO	ProShares Ultra S&P500
SSP	The E. W. Scripps Company
SSRI	Silver Standard Resources Inc.
SSS	Sovran Self Storage Inc.
SST	SPDR Barclays Short Term Trsy Bond ETF
SSTK	Shutterstock
SSW	Seaspan Corporation
SSY	SunLink Health Systems Inc.
SSYS	Stratasys Ltd.
ST	Sensata Technologies Holding NV
STAA	STAAR Surgical Company
STAG	STAG Industrial
STAR	iStar Financial Inc.
STAY	Extended Stay America
STB	Student Transportation
STBA	S&T Bancorp Inc.
STBZ	State Bank Financial Corporation
STC	Stewart Information Services Corporation
STCK	Stock Building Supply Holdings
STE	Steris Corp.
STEM	StemCells Inc.
STFC	State Auto Financial Corp.
STI	SunTrust Banks
STIP	iShares 0-5 Year TIPS Bond
STJ	St. Jude Medical Inc.
STKL	SunOpta Inc.
STL	Sterling Bancorp.
STLD	Steel Dynamics Inc.
STLY	Stanley Furniture Co. Inc.
STM	STMicroelectronics NV
STML	Stemline Therapeutics
STMP	Stamps.com Inc.
STN	Stantec Inc.
STND	Standard Financial Corp.
STNG	Scorpio Tankers Inc.
STNR	Steiner Leisure Ltd.
STO	Statoil ASA
STON	Stonemor Partners LP
STPP	iPath US Treasury Steepener ETN
STPZ	PIMCO 1-5 Year U.S. TIPS ETF
STR	Questar Corporation
STRA	Strayer Education Inc.
STRI	STR Holdings
STRL	Sterling Construction Co. Inc.
STRM	Streamline Health Solutions
STRN	Sutron Corporation
STRP	Straight Path Communications Inc.
STRS	Stratus Properties Inc.
STRT	STRATTEC Security Corporation
STRZA	Starz
STS	Supreme Industries Inc.
STT	State Street Corporation
STV	China Digital TV Holding Co.
STWD	Starwood Property Trust
STX	Seagate Technology Public Limited Company
STXS	Stereotaxis Inc.
STZ	Constellation Brands Inc.
SU	Suncor Energy Inc.
SUB	iShares ST National AMTFree Muni Bnd
SUBD	Deutsche X-trackers SlctvInvGrd SbdtDbt
SUBK	Suffolk Bancorp
SUI	Sun Communities Inc.
SUMR	Summer Infant
SUNE	SunEdison
SUNS	Solar Senior Capital Ltd.
SUP	Superior Industries International
SUPN	Supernus Pharmaceuticals
SURG	Synergetics USA
SUSP	Susser Petroleum Partners LP
SUSQ	Susquehanna Bancshares
SUSS	Susser Holdings Corporation
SUTR	Sutor Technology Group Limited
SVA	Sinovac Biotech Ltd.
SVBI	Severn Bancorp Inc.
SVBL	Silver Bull Resources
SVLC	Silvercrest Mines Inc.
SVM	Silvercorp Metals Inc.
SVT	Servotronics Inc.
SVU	SUPERVALU Inc.
SVXY	ProShares Short VIX Short-Term Futures
SWAY	Starwood Waypoint Residential Trust
SWC	Stillwater Mining Co.
SWFT	Swift Transportation Company
SWH	Stanley Black & Decker
SWHC	Smith & Wesson Holding Corporation
SWI	SolarWinds
SWIR	Sierra Wireless Inc.
SWK	Stanley Black & Decker
SWKS	Skyworks Solutions Inc.
SWM	Schweitzer-Mauduit International Inc.
SWN	Southwestern Energy Co.
SWS	SWS Group
SWSH	Swisher Hygiene Inc.
SWX	Southwest Gas Corporation
SWY	Safeway Inc.
SWZ	The Swiss Helvetia Fund Inc.
SXC	SunCoke Energy Inc.
SXCP	Suncoke Energy Partners
SXE	Southcross Energy Partners
SXI	Standex International Corporation
SXL	Sunoco Logistics Partners L.P.
SXT	Sensient Technologies Corporation
SYA	Symetra Financial Corporation
SYBT	Stock Yards Bancorp
SYK	Stryker Corporation
SYKE	Sykes Enterprises
SYLD	Cambria Shareholder Yield ETF
SYMC	Symantec Corporation
SYMX	Synthesis Energy Systems
SYN	Synthetic Biologics Inc.
SYNA	Synaptics Inc.
SYNC	Synacor
SYNL	Synalloy Corporation
SYNT	Syntel
SYPR	Sypris Solutions Inc.
SYRG	Synergy Resources Corporation
SYT	Syngenta AG
SYUT	Synutra International Inc.
SYX	Systemax Inc.
SYY	Sysco Corporation
SZK	ProShares UltraShort Consumer Goods
SZMK	Sizmek Inc.
SZO	PowerShares DB Crude Oil Short ETN
SZYM	Solazyme
T	AT&T
TA	TravelCenters of America LLC
TAC	TransAlta Corp.
TACT	TransAct Technologies Incorporated
TAHO	Tahoe Resources Inc.
TAI	Transamerica Income Shares Inc.
TAIT	Taitron Components Inc.
TAL	TAL International Group
TAM	Taminco Corporation
TAN	Guggenheim Solar ETF
TAO	Guggenheim China Real Estate ETF
TAOM	Taomee Holdings Ltd.
TAP	Molson Coors Brewing Company
TARO	Taro Pharmaceutical Industries Ltd.
TAS	Tasman Metals Ltd.
TASR	TASER International Inc.
TAST	Carrols Restaurant Group
TAT	TransAtlantic Petroleum Ltd.
TATT	TAT Technologies
TAX	Liberty Tax
TAXI	Medallion Financial Corp.
TAYC	Taylor Capital Group Inc.
TAYD	Taylor Devices Inc.
TBAR	RBS Gold Trendpilot ETN
TBBK	The Bancorp Inc.
TBF	ProShares Short 20+ Year Treasury
TBI	TrueBlue
TBIO	Transgenomic Inc.
TBNK	Territorial Bancorp Inc.
TBPH	Theravance Biopharma
TBT	ProShares UltraShort 20+ Year Treasury
TBX	ProShares Short 7-10 Year Treasury
TBZ	ProShares UltraShort 3-7 Year Treasury
TC	Thompson Creek Metals Company Inc.
TCAP	Triangle Capital Corporation
TCB	TCF Financial Corporation
TCBI	Texas Capital BancShares Inc.
TCBK	TriCo Bancshares
TCCO	Technical Communications Corporation
TCFC	The Community Financial Corp.
TCI	Transcontinental Realty Investors Inc.
TCK	Teck Resources Limited
TCO	Taubman Centers
TCP	TC PipeLines
TCRD	THL Credit
TCS	The Container Store Group
TCX	Tucows Inc.
TD	The Toronto-Dominion Bank
TDC	Teradata Corporation
TDD	Deutsche X-trackers 2010 Target Date
TDF	Templeton Dragon Fund
TDG	TransDigm Group Incorporated
TDH	Deutsche X-trackers 2020 Target Date
TDIV	First Trust NASDAQ Technology Dividend
TDN	Deutsche X-trackers 2030 Target Date
TDS	Telephone & Data Systems Inc.
TDTF	FlexShares iBoxx 5Yr Target Dur TIPS ETF
TDTT	FlexShares iBoxx 3Yr Target Dur TIPS ETF
TDV	Deutsche X-trackers 2040 Target Date
TDW	Tidewater Inc.
TDX	Deutsche X-trackers In Target Date
TDY	Teledyne Technologies Inc.
TE	TECO Energy
TEAR	TearLab Corporation
TECD	Tech Data Corp.
TECH	Techne Corp.
TECL	Direxion Daily Technology Bull 3X Shares
TECS	Direxion Daily Technology Bear 3X Shares
TECU	Tecumseh Products Company
TEDU	Tarena International
TEF	Telef
TEG	Integrys Energy Group
TEI	Templeton Emerging Markets Income Fund
TEL	TE Connectivity Ltd.
TELK	Telik Inc.
TEN	Tenneco Inc.
TENZ	PIMCO 7-15 Year U.S. Treasury ETF
TEO	Telecom Argentina S.A.
TEP	Tallgrass Energy Partners
TER	Teradyne Inc.
TESO	Tesco Corporation
TESS	TESSCO Technologies Inc.
TEU	Box Ships Inc.
TEVA	Teva Pharmaceutical Industries Limited
TEX	Terex Corp.
TFI	SPDR Nuveen Barclays Capital Muni Bond
TFLO	iShares Treasury Floating Rate Bond
TFM	The Fresh Market
TFSL	TFS Financial Corp
TFX	Teleflex Incorporated
TG	Tredegar Corp.
TGA	TransGlobe Energy Corporation
TGB	Taseko Mines Ltd.
TGC	Tengasco Inc.
TGD	Timmins Gold Corp.
TGE	TGC Industries Inc.
TGH	Textainer Group Holdings Limited
TGI	Triumph Group
TGLS	Tecnoglass Inc.
TGP	Teekay LNG Partners LP.
TGR	iShares Target Date Retirement Income
TGS	Transportadora de Gas Del Sur S.A.
TGT	Target Corp.
TGTX	TG Therapeutics
THC	Tenet Healthcare Corp.
THD	iShares MSCI Thailand Capped
THFF	First Financial Corp.
THG	The Hanover Insurance Group Inc.
THHY	Market Vectors Trs-Hdgd Hi-Yld Bd ETF
THI	Tim Hortons Inc.
THLD	Threshold Pharmaceuticals Inc.
THM	International Tower Hill Mines Ltd.
THO	Thor Industries Inc.
THOR	Thoratec Corp.
THR	Thermon Group Holdings
THRD	TF Financial Corporation
THRK	SPDR Russell 3000 ETF
THRM	Gentherm Incorporated
THRX	Theravance Inc.
THS	Treehouse Foods
THST	Truett-Hurst
THTI	THT Heat Transfer Technology
TI	Telecom Italia S.p.A.
TI-A	Telecom Italia S.p.A.
TIBX	TIBCO Software Inc.
TICC	TICC Capital Corp.
TIF	Tiffany & Co.
TIGR	TigerLogic Corporation
TIK	Tel-Instrument Electronics Corp.
TILE	Interface Inc.
TILT	FlexShares Mstar US Mkt Factors Tilt ETF
TIME	Time Inc.
TINY	Harris & Harris Group
TIP	iShares TIPS Bond
TIPT	Tiptree Financial Inc.
TIPX	SPDR Barclays 1-10 Year TIPS ETF
TIPZ	PIMCO Broad U.S. TIPS ETF
TIS	Orchids Paper Products Company
TISA	Top Image Systems Ltd.
TISI	Team
TITN	Titan Machinery
TIVO	TiVo Inc.
TJX	The TJX Companies
TK	Teekay Corporation
TKC	Turkcell Iletisim Hizmetleri AS
TKF	Turkish Investment Fund
TKMR	Tekmira Pharmaceuticals Corp.
TKR	Timken Co.
TLF	Tandy Leather Factory
TLH	iShares 10-20 Year Treasury Bond
TLI	LMP Corporate Loan Fund Inc.
TLK	PT Telekomunikasi Indonesia Tbk
TLL	ProShares UltraShort Telecommunications
TLLP	Tesoro Logistics LP
TLM	Talisman Energy Inc.
TLMR	Talmer Bancorp
TLO	SPDR Barclays Long Term Treasury ETF
TLOG	TetraLogic Pharmaceuticals Corporation
TLP	Transmontaigne Partners L.P.
TLR	Timberline Resources Corporation
TLT	iShares 20+ Year Treasury Bond
TLTD	FlexShares Mstar Dev Mk ex-US Fct Tl Idx
TLTE	FlexShares Mstar Emrg Mkts Fct Tl Idx
TLYS	Tilly's
TM	Toyota Motor Corporation
TMF	Direxion Daily 20+ Yr Trsy Bull 3X Shrs
TMH	Team Health Holdings
TMHC	Taylor Morrison Home Corporation
TMK	Torchmark Corporation
TMO	Thermo Fisher Scientific
TMP	Tompkins Financial Corporation
TMUS	T-Mobile US
TMV	Direxion Daily 20+ Yr Trsy Bear 3X Shrs
TNA	Direxion Daily Small Cap Bull 3X Shares
TNAV	Telenav
TNC	Tennant Company
TNDM	Tandem Diabetes Care
TNDQ	RBS NASDAQ 100 Trendpilot ETN
TNET	TriNet Group
TNGO	Tangoe
TNH	Terra Nitrogen Company
TNK	Teekay Tankers Ltd.
TNP	Tsakos Energy Navigation Limited
TNXP	Tonix Pharmaceuticals Holding Corp
TOF	Tofutti Brands Inc.
TOK	iShares MSCI Kokusai
TOL	Toll Brothers Inc.
TOO	Teekay Offshore Partners LP
TOPS	Top Ships Inc.
TORM	TOR Minerals International Inc.
TOT	Total SA
TOTS	Direxion Daily Total Mkt Bear 1X Shares
TOUR	Tuniu Corporation
TOWN	Towne Bank
TOWR	Tower International
TPC	Tutor Perini Corporation
TPH	TRI Pointe Homes
TPI	Tianyin Pharmaceutical Co.
TPL	Texas Pacific Land Trust
TPLM	Triangle Petroleum Corporation
TPRE	Third Point Reinsurance Ltd.
TPS	ProShares UltraShort TIPs
TPX	Tempur Sealy International Inc.
TQNT	TriQuint Semiconductor
TQQQ	ProShares UltraPro QQQ
TR	Tootsie Roll Industries Inc.
TRAK	Dealertrack Technologies
TRC	Tejon Ranch Co.
TRCB	Two River Bancorp
TREC	Trecora Resources
TREE	Tree.Com
TREX	Trex Co. Inc.
TRF	Templeton Russia and East European Fund Inc.
TRGP	Targa Resources Corp.
TRGT	Targacept
TRI	Thomson Reuters Corporation
TRIB	Trinity Biotech plc
TRIP	TripAdvisor Inc.
TRIV	TriVascular Technologies
TRK	Speedway Motorsports Inc.
TRLA	Trulia
TRMB	Trimble Navigation Limited
TRMK	Trustmark Corporation
TRMR	Tremor Video
TRN	Trinity Industries Inc.
TRND	RBS US Large Cap Trendpilot ETN
TRNM	RBS US Mid Cap Trendpilot ETN
TRNO	Terreno Realty Corp.
TRNS	Transcat Inc.
TRNX	Tornier N.V.
TROV	TrovaGene
TROW	T. Rowe Price Group
TROX	Tronox Limited
TRP	TransCanada Corp.
TRQ	Turquoise Hill Resources Ltd.
TRR	TRC Companies Inc.
TRS	TriMas Corporation
TRSK	VelocityShares Tail Risk Hdgd Lg Cp ETF
TRST	TrustCo Bank Corp. NY
TRT	Trio-Tech International
TRUE	TrueCar
TRV	The Travelers Companies
TRVN	Trevena
TRW	TRW Automotive Holdings Corp.
TRX	Tanzanian Royalty Exploration Corp.
TRXC	TransEnterix
TS	Tenaris SA
TSBK	Timberland Bancorp
TSC	Tristate Capital Holdings
TSCO	Tractor Supply Company
TSE	Trinseo SA
TSEM	Tower Semiconductor Ltd.
TSI	TCW Strategic Income Fund
TSL	Trina Solar Limited
TSLA	Tesla Motors
TSLX	TPG Specialty Lending
TSM	Taiwan Semiconductor Manufacturing Company Limited
TSN	Tyson Foods
TSO	Tesoro Corporation
TSPT	Transcept Pharmaceuticals
TSRA	Tessera Technologies Inc.
TSRE	Trade Street Residential
TSRI	TSR
TSRO	Tesaro
TSS	Total System Services
TST	TheStreet
TSU	TIM Participacoes S.A.
TSYS	TeleCommunication Systems Inc.
TTC	Toro Co.
TTEC	TeleTech Holdings Inc.
TTEK	Tetra Tech Inc.
TTF	Thai Fund
TTFS	AdvisorShares TrimTabs Float Shrink ETF
TTGT	TechTarget
TTHI	Transition Therapeutics Inc.
TTI	TETRA Technologies
TTM	Tata Motors Limited
TTMI	TTM Technologies Inc.
TTPH	Tetraphase Pharmaceuticals
TTS	Tile Shop Holdings
TTT	ProShares UltraPro Short 20+ Year Trs
TTWO	Take-Two Interactive Software Inc.
TU	TELUS Corporation
TUES	Tuesday Morning Corporation
TUMI	Tumi Holdings
TUP	Tupperware Brands Corporation
TUR	iShares MSCI Turkey
TUZ	PIMCO 1-3 Year U.S. Treasury ETF
TV	Grupo Televisa
TVIX	VelocityShares Daily 2x VIX ST ETN
TVIZ	VelocityShares Daily 2x VIX MT ETN
TW	Towers Watson & Co.
TWC	Time Warner Cable Inc.
TWER	Towerstream Corporation
TWGP	Tower Group International
TWI	Titan International Inc.
TWIN	Twin Disc
TWM	ProShares UltraShort Russell2000
TWMC	Trans World Entertainment Corporation
TWN	Taiwan Fund
TWO	Two Harbors Investment Corp.
TWOK	SPDR Russell 2000 ETF
TWOU	2U
TWQ	ProShares UltraShort Russell3000
TWTC	TW Telecom Inc.
TWTI	RBS Oil Trendpilot ETN
TWTR	Twitter
TWX	Time Warner Inc.
TX	Ternium S.A.
TXMD	TherapeuticsMD
TXN	Texas Instruments Inc.
TXRH	Texas Roadhouse
TXT	Textron Inc.
TXTR	Textura Corporation
TY	Tri Continental Corporation Com
TYBS	Direxion Daily 20+ Year Treasury Bear 1X
TYC	Tyco International Ltd.
TYD	Direxion Daily 7-10 Yr Trsy Bull 3X Shrs
TYG	Tortoise Energy Infrastructure 
TYL	Tyler Technologies
TYNS	Direxion Daily 7-10 Yr Treasury Bear 1X
TYO	Direxion Daily 7-10 Yr Trsy Bear 3X Shrs
TYPE	Monotype Imaging Holdings Inc.
TYTE	ProShares CDS North American HY Crdt ETF
TZA	Direxion Daily Small Cap Bear 3X Shares
TZD	iShares Target Date 2010
TZE	iShares Target Date 2015
TZG	iShares Target Date 2020
TZI	iShares Target Date 2025
TZL	iShares Target Date 2030
TZO	iShares Target Date 2035
TZOO	Travelzoo Inc.
TZV	iShares Target Date 2040
UA	Under Armour
UACL	Universal Truckload Services Inc.
UAE	iShares MSCI UAE Capped
UAG	UBS E-TRACS CMCI Agriculture TR ETN
UAL	United Continental Holdings
UAM	Universal American Corp
UAMY	United States Antimony Corp.
UAN	CVR Partners
UBA	Urstadt Biddle Properties Inc.
UBC	UBS E-TRACS CMCI Livestock TR ETN
UBCP	United Bancorp Inc.
UBFO	United Security Bancshares
UBG	UBS E-TRACS CMCI Gold TR ETN
UBIC	UBIC
UBM	UBS E-TRACS CMCI Industrial Mtls TR ETN
UBN	UBS E-TRACS CMCI Energy TR ETN
UBNK	United Financial Bancorp
UBNT	Ubiquiti Networks
UBOH	United Bancshares Inc.
UBR	ProShares Ultra MSCI Brazil Capped
UBS	UBS AG
UBSH	Union Bankshares Corporation
UBSI	United Bankshares Inc.
UBT	ProShares Ultra 20+ Year Treasury
UCBA	United Community Bancorp
UCBI	United Community Banks
UCC	ProShares Ultra Consumer Services
UCD	ProShares Ultra Bloomberg Commodity
UCFC	United Community Financial Corp.
UCI	UBS E-TRACS CMCI TR ETN
UCO	ProShares Ultra Bloomberg Crude Oil
UCP	UCP
UCTT	Ultra Clean Holdings Inc.
UDF	United Development Funding IV
UDN	PowerShares DB US Dollar Bearish ETF
UDOW	ProShares UltraPro Dow30
UDR	UDR
UEC	Uranium Energy Corp.
UEIC	Universal Electronics Inc.
UEPS	Net 1 Ueps Technologies Inc.
UFCS	United Fire Group
UFI	Unifi Inc.
UFPI	Universal Forest Products Inc.
UFPT	UFP Technologies
UFS	Domtar Corporation
UG	United-Guardian Inc.
UGA	United States Gasoline
UGAZ	VelocityShares 3x Long Natural Gas ETN
UGE	ProShares Ultra Consumer Goods
UGI	UGI Corporation
UGL	ProShares Ultra Gold
UGP	Ultrapar Holdings Inc.
UHAL	AMERCO
UHN	United States Diesel-Heating Oil
UHS	Universal Health Services Inc.
UHT	Universal Health Realty Income Trust
UIHC	United Insurance Holdings Corp.
UIL	UIL Holdings Corporation
UINF	ProShares UltraPro 10 Year TIPS/TSY Sprd
UIS	Unisys Corporation
UJB	ProShares Ultra High Yield
UKF	ProShares Ultra Russell1000 Growth
UKK	ProShares Ultra Russell2000 Growth
UKW	ProShares Ultra Russell MidCap Growth
UL	Unilever plc
ULBI	Ultralife Corp.
ULE	ProShares Ultra Euro
ULTA	ULTA Salon
ULTI	The Ultimate Software Group
ULTR	Ultrapetrol
UMBF	UMB Financial Corporation
UMC	United Microelectronics Corporation
UMDD	ProShares UltraPro MidCap400
UMH	UMH Properties Inc.
UMPQ	Umpqua Holdings Corporation
UMX	ProShares Ultra MSCI Mexico Capped IMI
UN	Unilever NV
UNAM	Unico American Corp.
UNB	Union Bankshares
UNF	UniFirst Corp.
UNFI	United Natural Foods
UNG	United States Natural Gas
UNH	UnitedHealth Group Incorporated
UNIS	Unilife Corporation
UNL	United States 12 Month Natural Gas
UNM	Unum Group
UNP	Union Pacific Corporation
UNS	UNS Energy Corporation
UNT	Unit Corporation
UNTD	United Online
UNTK	UniTek Global Services
UNTY	Unity Bancorp Inc.
UNXL	Uni-Pixel
UPI	Uroplasty
UPIP	Unwired Planet
UPL	Ultra Petroleum Corp.
UPRO	ProShares UltraPro S&P500
UPS	United Parcel Service
UPV	ProShares Ultra FTSE Europe
UPW	ProShares Ultra Utilities
UQM	UQM Technologies Inc.
URA	Global X Uranium ETF
URBN	Urban Outfitters Inc.
URE	ProShares Ultra Real Estate
URG	UR-Energy Inc.
URI	United Rentals
URRE	Uranium Resources
URS	URS Corporation
URTH	iShares MSCI World
URTY	ProShares UltraPro Russell2000
URZ	Uranerz Energy Corp.
USA	Liberty All Star Equity Fund
USAC	USA Compression Partners
USAK	USA Truck Inc.
USAP	Universal Stainless & Alloy Products Inc.
USAT	USA Technologies Inc.
USB	U.S. Bancorp
USBI	United Security Bancshares Inc.
USCI	United States Commodity Index
USCR	U.S. Concrete
USD	ProShares Ultra Semiconductors
USEG	US Energy Corp.
USFR	WisdomTree Bloomberg Floating Rate Trs
USG	USG Corporation
USL	United States 12 Month Oil
USLM	United States Lime & Minerals
USM	United States Cellular Corporation
USMD	USMD Holdings
USMI	United States Metals Index
USNA	USANA Health Sciences Inc.
USO	United States Oil
USPH	US Physical Therapy Inc.
UST	ProShares Ultra 7-10 Year Treasury
USTR	United Stationers Inc.
USU	USEC Inc.
USV	UBS E-TRACS CMCI Silver TR ETN
UTEK	Ultratech
UTF	Cohen & Steers Infrastructure Fund
UTG	Reaves Utility Income Fund
UTHR	United Therapeutics Corporation
UTI	Universal Technical Institute
UTIW	UTi Worldwide Inc.
UTL	Unitil Corp.
UTLT	Deutsche X-trackers Regulated Utilities
UTMD	Utah Medical Products Inc.
UTSI	UTStarcom Holdings Corp.
UTX	United Technologies Corp.
UUP	PowerShares DB US Dollar Bullish ETF
UUU	Universal Security Instruments Inc.
UVE	Universal Insurance Holdings Inc.
UVG	ProShares Ultra Russell1000 Value
UVSP	Univest Corporation of Pennsylvania
UVT	ProShares Ultra Russell2000 Value
UVU	ProShares Ultra Russell MidCap Value
UVV	Universal Corporation
UVXY	ProShares Ultra VIX Short-Term Futures
UWC	ProShares Ultra Russell3000
UWM	ProShares Ultra Russell2000
UWN	Nevada Gold & Casinos Inc.
UWTI	VelocityShares 3x Long Crude ETN
UXI	ProShares Ultra Industrials
UXJ	ProShares Ultra MSCI Pacific ex-Japan
UYG	ProShares Ultra Financials
UYM	ProShares Ultra Basic Materials
V	Visa Inc.
VAC	Marriott Vacations Worldwide Corp.
VAL	The Valspar Corporation
VALE	Vale S.A.
VALU	Value Line
VAR	Varian Medical Systems
VASC	Vascular Solutions Inc.
VAW	Vanguard Materials ETF
VB	Vanguard Small-Cap ETF
VBF	Invesco Bond Fund Common Stock
VBFC	Village Bank & Trust Financial Corp.
VBK	Vanguard Small-Cap Growth ETF
VBR	Vanguard Small-Cap Value ETF
VC	Visteon Corporation
VCF	Delaware Investments Colorado Municipal Income Fund
VCIT	Vanguard Intermediate-Term Corp Bd ETF
VCLT	Vanguard Long-Term Corp Bond Idx ETF
VCO	Vina Concha y Toro S.A.
VCR	Vanguard Consumer Discretionary ETF
VCRA	Vocera Communications
VCSH	Vanguard Short-Term Corporate Bond ETF
VCV	Invesco Van Kampen California Value Municipal Income Trust
VCYT	Veracyte
VDC	Vanguard Consumer Staples ETF
VDE	Vanguard Energy ETF
VDSI	VASCO Data Security International Inc.
VE	Veolia Environnement S.A.
VEA	Vanguard FTSE Developed Markets ETF
VECO	Veeco Instruments Inc.
VEEV	Veeva Systems Inc.
VEGA	AdvisorShares STAR Global Buy-Write ETF
VEGI	iShares MSCI Glbl Agriculture Producers
VET	Vermilion Energy Inc.
VEU	Vanguard FTSE All-World ex-US ETF
VFC	V.F. Corporation
VFH	Vanguard Financials ETF
VFL	Delaware Investments National Municipal Income Fund
VG	Vonage Holdings Corporation
VGGL	Viggle Inc.
VGIT	Vanguard Intermediate-Term Govt Bd ETF
VGK	Vanguard FTSE Europe ETF
VGLT	Vanguard Long-Term Government Bond ETF
VGM	Invesco Van Kampen Trust for Investment Grade Municipals
VGR	Vector Group Ltd.
VGSH	Vanguard Short-Term Govt Bd Idx ETF
VGT	Vanguard Information Technology ETF
VGZ	Vista Gold Corp.
VHC	VirnetX Holding Corp
VHI	Valhi
VHT	Vanguard Health Care ETF
VIAB	Viacom
VIAS	Viasystems Group
VICL	Vical Incorporated
VICR	Vicor Corp.
VIDE	Video Display Corporation
VIDI	Vident International Equity
VIEW	Viewtran Group
VIG	Vanguard Dividend Appreciation ETF
VII	Vicon Industries Inc.
VIIX	VelocityShares Long VIX ST ETN
VIIZ	VelocityShares Long VIX MT ETN
VIMC	Vimicro International Corp.
VIOG	Vanguard S&P Small-Cap 600 Growth ETF
VIOO	Vanguard S&P Small-Cap 600 ETF
VIOV	Vanguard S&P Small-Cap 600 Value ETF
VIP	VimpelCom Ltd.
VIPS	Vipshop Holdings Limited
VIRC	Virco Mfg. Corporation
VIS	Vanguard Industrials ETF
VISN	VisionChina Media Inc.
VITC	Vitacost.com
VIV	Telefonica Brasil
VIVO	Meridian Bioscience
VIXH	First Trust CBOE S&P 500 VIX Tail Hedge
VIXM	ProShares VIX Mid-Term Futures
VIXY	ProShares VIX Short-Term Futures
VJET	Voxeljet AG
VKI	Invesco Advantage Municipal Inc
VKQ	Invesco Municipal Trust Common 
VLCCF	Knightsbridge Tankers Limited
VLGEA	Village Super Market Inc.
VLO	Valero Energy Corporation
VLP	Valero Energy Partners LP
VLRS	Controladora Vuela Compa
VLT	Invesco High Income Trust II
VLTC	Voltari Corporation
VLUE	iShares MSCI USA Value Factor
VLY	Valley National Bancorp
VMBS	Vanguard Mortgage-Backed Securities ETF
VMC	Vulcan Materials Company
VMEM	Violin Memory
VMI	Valmont Industries
VMM	Delaware Investments Minnesota 
VMO	Invesco Van Kampen Municipal Opportunity Trust
VMW	VMware
VNCE	Vince Holding Corp
VNDA	Vanda Pharmaceuticals
VNET	21Vianet Group
VNM	Market Vectors Vietnam ETF
VNO	Vornado Realty Trust
VNOM	Viper Energy Partners LP
VNQ	Vanguard REIT ETF
VNQI	Vanguard Global ex-US Real Estate ETF
VNR	Vanguard Natural Resources
VNTV	Vantiv
VO	Vanguard Mid-Cap ETF
VOC	VOC Energy Trust
VOD	Vodafone Group Public Limited Company
VOE	Vanguard Mid-Cap Value ETF
VOLC	Volcano Corporation
VONE	Vanguard Russell 1000 ETF
VONG	Vanguard Russell 1000 Growth Index ETF
VONV	Vanguard Russell 1000 Value ETF
VOO	Vanguard S&P 500 ETF
VOOG	Vanguard S&P 500 Growth ETF
VOOV	Vanguard S&P 500 Value ETF
VOT	Vanguard Mid-Cap Growth ETF
VOX	Vanguard Telecommunication Services ETF
VOXX	VOXX International Corporation
VOYA	Voya Financial
VPCO	Vapor Corp.
VPFG	ViewPoint Financial Group
VPG	Vishay Precision Group
VPL	Vanguard FTSE Pacific ETF
VPRT	Vistaprint N.V.
VPU	Vanguard Utilities ETF
VPV	Invesco Van Kampen Pennsylvania Value Municipal Income Trust
VQT	Barclays S&P 500 Dynamic VEQTOR ETN
VR	Validus Holdings
VRA	Vera Bradley
VRD	SPDR Nuveen S&P VRDO Municipal Bond
VRML	Vermillion
VRNG	Vringo
VRNS	Varonis Systems
VRNT	Verint Systems Inc.
VRP	PowerShares Variable Rate Preferred ETF
VRS	Verso Paper Corp.
VRSK	Verisk Analytics
VRSN	VeriSign
VRTA	Vestin Realty Mortgage I
VRTB	Vestin Realty Mortgage II
VRTS	Virtus Investment Partners
VRTU	Virtusa  Corp.
VRTX	Vertex Pharmaceuticals Incorporated
VRX	Valeant Pharmaceuticals International
VSAR	Versartis
VSAT	ViaSat Inc.
VSCI	Vision-Sciences Inc.
VSCP	VirtualScopics Inc.
VSEC	VSE Corp.
VSH	Vishay Intertechnology Inc.
VSI	Vitamin Shoppe
VSPY	Direxion S&P 500 Volatility Response
VSR	Versar Inc.
VSS	Vanguard FTSE All-World ex-US Sm-Cp ETF
VSTM	Verastem
VT	Vanguard Total World Stock ETF
VTA	Invesco Van Kampen Dynamic Cred
VTG	Vantage Drilling Company
VTHR	Vanguard Russell 3000 Index ETF
VTI	Vanguard Total Stock Market ETF
VTIP	Vanguard Short-Term Infl-Prot Secs ETF
VTL	Vital Therapies
VTN	Invesco Van Kampen Trust for Investment Grade New York Municipals
VTNR	Vertex Energy
VTR	Ventas
VTSS	Vitesse Semiconductor Corp.
VTV	Vanguard Value ETF
VTWG	Vanguard Russell 2000 Growth ETF
VTWO	Vanguard Russell 2000 ETF
VTWV	Vanguard Russell 2000 Value ETF
VUG	Vanguard Growth ETF
VUSE	Vident Core US Equity
VV	Vanguard Large-Cap ETF
VVC	Vectren Corporation
VVI	Viad Corp
VVR	Invesco Van Kampen Senior Income Trust
VVTV	ValueVision Media Inc.
VVUS	VIVUS Inc.
VWO	Vanguard FTSE Emerging Markets ETF
VWOB	Vanguard Emerging Markets Govt Bd ETF
VXF	Vanguard Extended Market ETF
VXUS	Vanguard Total International Stock ETF
VXX	iPath S&P 500 VIX ST Futures ETN
VXZ	iPath S&P 500 VIX MT Futures ETN
VYFC	Valley Financial Corporation
VYM	Vanguard High Dividend Yield ETF
VZ	Verizon Communications Inc.
WAB	Westinghouse Air Brake Technologies Corporation
WABC	Westamerica Bancorp.
WAC	Walter Investment Management Corp.
WACLY	Wacoal Holdings Corp.
WAFD	Washington Federal Inc.
WAG	Walgreen Co.
WAGE	WageWorks
WAIR	Wesco Aircraft Holdings
WAL	Western Alliance Bancorporation
WASH	Washington Trust Bancorp Inc.
WAT	Waters Corporation
WATT	Energous Corporation
WAVX	Wave Systems Corp.
WAYN	Wayne Savings Bancshares Inc.
WB	Weibo Corporation
WBAI	500.com Limited
WBB	Westbury Bancorp
WBC	WABCO Holdings Inc.
WBK	Westpac Banking Corporation
WBKC	Wolverine Bancorp
WBMD	WebMD Health Corp.
WBS	Webster Financial Corp.
WCC	WESCO International Inc.
WCG	WellCare Health Plans
WCN	Waste Connections Inc.
WD	Walker & Dunlop
WDAY	Workday
WDC	Western Digital Corporation
WDFC	WD-40 Company
WDIV	SPDR S&P Global Dividend ETF
WDR	Waddell & Reed Financial
WDTI	WisdomTree Managed Futures Strategy
WEA	Western Asset Premier Bond Fund
WEAT	Teucrium Wheat ETF
WEBK	Wellesley Bancorp
WEC	Wisconsin Energy Corp.
WEET	iPath Pure Beta Grains ETN
WEN	The Wendy's Company
WERN	Werner Enterprises Inc.
WES	Western Gas Partners LP
WETF	WisdomTree Investments
WEX	WEX Inc.
WEYS	Weyco Group Inc.
WF	Woori Finance Holdings Co.
WFBI	WashingtonFirst Bankshares Inc.
WFC	Wells Fargo & Company
WFD	Westfield Financial Inc.
WFM	Whole Foods Market
WFT	Weatherford International plc
WG	Willbros Group Inc.
WGA	Wells-Gardner Electronics Corp.
WGL	WGL Holdings Inc.
WGO	Winnebago Industries
WGP	Western Gas Equity Partners
WH	WSP Holdings Ltd.
WHG	Westwood Holdings Group Inc.
WHLM	Wilhelmina International
WHLR	Wheeler Real Estate Investment Trust
WHR	Whirlpool Corp.
WHX	Whiting USA Trust I
WHZ	Whiting USA Trust II
WIA	Western Asset/Claymore Inflation-Linked Securities & Income Fund
WIBC	Wilshire Bancorp Inc.
WIFI	Boingo Wireless
WILC	G. Willi Food-International Ltd.
WIN	Windstream Holdings
WINA	Winmark Corp.
WIP	SPDR DB Intl Govt Infl-Protected Bond
WIRE	Encore Wire Corp.
WIT	Wipro Ltd.
WITE	ETFS Physical White Metals Basket Shares
WIW	Western Asset/Claymore Inflation- Linked Opportunities & Income Fund
WIX	Wix.com Ltd.
WLB	Westmoreland Coal Co.
WLDN	Willdan Group
WLFC	Willis Lease Finance Corp.
WLK	Westlake Chemical Corp.
WLL	Whiting Petroleum Corp.
WLP	WellPoint Inc.
WLT	Walter Energy
WM	Waste Management
WMAR	West Marine Inc.
WMB	Williams Companies
WMC	Western Asset Mortgage Capital Corporation
WMCR	Wilshire Micro-Cap ETF
WMGI	Wright Medical Group Inc.
WMK	Weis Markets
WMS	Advanced Drainage Systems
WMT	Wal-Mart Stores Inc.
WMW	ELEMENTS Morningstar Wide Moat Focus ETN
WNC	Wabash National Corp.
WNR	Western Refining
WNRL	Western Refining Logistics
WNS	WNS (Holdings) Limited
WOOD	iShares Global Timber & Forestry
WOOF	VCA Inc.
WOR	Worthington Industries
WPC	W. P. Carey Inc.
WPCS	WPCS International Incorporated
WPG	Washington Prime Group Inc.
WPP	Wausau Paper Corp.
WPPGY	WPP plc
WPRT	Westport Innovations Inc.
WPS	iShares International Developed Property
WPT	World Point Terminals
WPX	WPX Energy
WPZ	Williams Partners L.P.
WR	Westar Energy
WRB	W.R. Berkley Corporation
WRE	Washington Real Estate Investment Trust
WREI	Wilshire US REIT ETF
WRES	Warren Resources Inc.
WRI	Weingarten Realty Investors
WRLD	World Acceptance Corp.
WSBC	WesBanco Inc.
WSBF	Waterstone Financial
WSCI	WSI Industries Inc.
WSFS	WSFS Financial Corp.
WSH	Willis Group Holdings Public Limited Company
WSM	Williams-Sonoma Inc.
WSO	Watsco Inc.
WSR	Whitestone REIT
WST	West Pharmaceutical Services
WSTC	West Corporation
WSTG	Wayside Technology Group
WSTL	Westell Technologies
WTBA	West Bancorp.
WTFC	Wintrust Financial Corporation
WTI	W&T Offshore Inc.
WTM	White Mountains Insurance Group
WTR	Aqua America Inc.
WTS	Watts Water Technologies
WTSL	The Wet Seal
WTT	Wireless Telecom Group Inc.
WTW	Weight Watchers International
WU	The Western Union Company
WUBA	58.com Inc.
WVFC	WVS Financial Corp.
WVVI	Willamette Valley Vineyards Inc.
WWAV	The WhiteWave Foods Company
WWD	Woodward
WWE	World Wrestling Entertainment Inc.
WWW	Wolverine World Wide Inc.
WWWW	Web.com Group
WX	WuXi PharmaTech
WY	Weyerhaeuser Co.
WYDE	ProShares CDS Shrt Nrth Amer HY Crdt ETF
WYN	Wyndham Worldwide Corporation
WYNN	Wynn Resorts Ltd.
WYY	WidePoint Corp.
X	United States Steel Corp.
XAA	American Municipal Income Portfolio Inc.
XBI	SPDR S&P Biotech ETF
XBKS	Xenith Bankshares
XCO	EXCO Resources Inc.
XCRA	Xcerra Corporation
XEC	Cimarex Energy Co.
XEL	Xcel Energy Inc.
XES	SPDR S&P Oil & Gas Equipment & Svcs ETF
XGTI	xG Technology
XHB	SPDR S&P Homebuilders ETF
XHE	SPDR S&P Health Care Equipment ETF
XIN	Xinyuan Real Estate Co.
XIV	VelocityShares Daily Inverse VIX ST ETN
XL	XL Group plc
XLB	Materials Select Sector SPDR ETF
XLE	Energy Select Sector SPDR ETF
XLF	Financial Select Sector SPDR ETF
XLG	Guggenheim Russell Top 50 Mega Cap ETF
XLI	Industrial Select Sector SPDR ETF
XLK	Technology Select Sector SPDR ETF
XLNX	Xilinx Inc.
XLP	Consumer Staples Select Sector SPDR ETF
XLRN	Acceleron Pharma
XLS	Exelis Inc.
XLU	Utilities Select Sector SPDR ETF
XLV	Health Care Select Sector SPDR ETF
XLY	Consumer Discret Select Sector SPDR ETF
XME	SPDR S&P Metals & Mining ETF
XMLV	PowerShares S&P MidCap Low Volatil ETF
XMPT	Market Vectors CEF Municipal Income ETF
XNCR	Xencor
XNPT	Xenoport
XNY	China Xiniya Fashion Limited
XOM	Exxon Mobil Corporation
XOMA	XOMA Corporation
XON	Intrexon Corporation
XONE	The ExOne Company
XOOM	Xoom Corporation
XOP	SPDR S&P Oil & Gas Explor & Prod ETF
XOVR	SPDR BofA ML Crossover Corp Bond ETF
XOXO	XO Group Inc.
XPH	SPDR S&P Pharmaceuticals ETF
XPL	Solitario Exploration & Royalty Corp.
XPLR	Xplore Technologies Corp.
XPO	XPO Logistics
XPP	ProShares Ultra FTSE China 25
XRA	Exeter Resource Corporation
XRAY	DENTSPLY International Inc.
XRM	Xerium Technologies Inc.
XRS	TAL Education Group
XRSC	XRS Corporation
XRT	SPDR S&P Retail ETF
XRX	Xerox Corporation
XSD	SPDR S&P Semiconductor ETF
XSLV	PowerShares S&P SmallCap Low Volatil ETF
XTL	SPDR S&P Telecom ETF
XTN	SPDR S&P Transportation ETF
XUE	Xueda Education Group
XVIX	UBS E-TRACS Daily Long-Short VIX ETN
XVZ	iPath S&P 500 Dynamic VIX ETN
XWES	World Energy Solutions
XXIA	Ixia
XXII	22nd Century Group
XXV	iPath Inverse S&P 500 VIX ST Fut ETN
XYL	Xylem Inc.
Y	Alleghany Corporation
YANG	Direxion Daily China Bear 3X Shares
YAO	Guggenheim China All-Cap ETF
YCL	ProShares Ultra Yen
YCS	ProShares UltraShort Yen
YDIV	First Trust Intl Multi-Asst Divers Inc
YDKN	Yadkin Financial Corporation
YELP	Yelp
YGE	Yingli Green Energy Holding Co. Ltd.
YHOO	Yahoo! Inc.
YINN	Direxion Daily China Bull 3X Shares
YMLI	Yorkville High Income Infras MLP ETF
YNDX	Yandex N.V.
YOD	YOU On Demand Holdings
YOKU	Youku Tudou Inc.
YORW	The York Water Company
YPF	YPF S.A.
YRCW	YRC Worldwide Inc.
YUM	Yum! Brands
YUME	YuMe
YXI	ProShares Short FTSE China 25
YY	YY Inc.
YYY	YieldShares High Income ETF
YZC	Yanzhou Coal Mining Co. Ltd.
Z	Zillow
ZA	Zuoan Fashion Limited
ZAGG	ZAGG Inc
ZAZA	ZaZa Energy Corporation
ZBB	ZBB Energy Corporation
ZBRA	Zebra Technologies Corp.
ZEN	Zendesk
ZEP	Zep
ZEUS	Olympic Steel Inc.
ZF	Zweig Fund
ZFC	ZAIS Financial Corp.
ZFGN	Zafgen
ZGNX	Zogenix
ZHNE	Zhone Technologies Inc.
ZINC	Horsehead Holding Corp.
ZION	Zions Bancorporation
ZIOP	ZIOPHARM Oncology
ZIPR	zipRealty Inc.
ZIV	VelocityShares Daily Inverse VIX MT ETN
ZIXI	Zix Corporation
ZLTQ	ZELTIQ Aesthetics
ZMH	Zimmer Holdings
ZMLP	Direxion Zacks MLP High Income Shares
ZN	Zion Oil & Gas
ZNGA	Zynga
ZNH	China Southern Airlines Co. Ltd.
ZOES	Zoe's Kitchen
ZOOM	ZOOM Technologies
ZPIN	Zhaopin Ltd.
ZQK	Quiksilver Inc.
ZROZ	PIMCO 25+ Year Zero Coupon U.S. Trs ETF
ZSL	ProShares UltraShort Silver
ZSPH	ZS Pharma
ZTR	Zweig Total Return Fund Inc.
ZTS	Zoetis Inc.
ZU	zulily
ZUMZ	Zumiez
ZX	China Zenix Auto International Limited
